,0,Minimum_A_F,Maximum_A_F,RMS_A_F,Variance_A_F,STD_A_F,RangeA_F,Minimum_A_V,Maximum_A_V,RMS_A_V,Variance_A_V,RangeA_V,Minimum_A_L,RMS_A_L,Variance_A_L,RangeA_L,EN_A_F,EN_A_V,EN_A_L
8203,0,-606,1000,379.1405783,94373.34937000001,307.2024566,1606,431,1529,1105.287236,74150.26465,1098,-465,257.4418927,25377.58569,999,9199845,78186232,4241685
6414,0,131,171,148.91608380000002,77.31933594,8.793141415,40,960,1000,981.1480839,106.61621090000001,40,306,324.5830017,94.43359375,50,1419264,61609700,6742664
7376,0,-888,858,345.5105823,89286.15527,298.8078902,1746,264,1715,1139.054693,103206.4336,1451,-772,240.68694010000002,26893.673580000002,1187,7640164,83036518,3707533
10675,0,151,242,212.87088959999997,323.62866210000004,17.989682100000003,91,990,1039,1008.825276,151.875,49,118,152.9070388,305.0537109,70,2900097,65134620,1496356
4503,0,-2000,2131,767.0005602000001,561224.4685,749.1491631,4131,245,2323,1255.3670650000001,213400.9521,2078,-1227,390.5792373,94629.18921,2306,37650551,100860574,9763337
10729,0,404,464,427.87965599999995,110.9375,10.53268722,60,921,970,945.6222075,83.36889648,49,0,28.66318414,173.71655269999997,59,11717184,57228887,52581
9139,0,-40,101,58.06852095,1048.411865,32.37918877,141,931,1098,1004.003323,1229.9255369999998,167,227,283.938181,947.0075684000001,119,215805,64513451,5159737
3969,0,232,292,266.8196957,237.109375,15.39835624,60,960,1019,983.6204251,206.15600590000003,59,188,216.6425628,169.9375,69,4556336,61920585,3003776
2240,0,-161,-111,127.1849048,102.5146484,10.12495177,50,980,1029,1004.937786,94.78491211,49,227,246.30824180000002,120.99609380000001,50,1035264,64633597,3882736
2951,0,-272,-222,247.82604790000002,99.609375,9.980449639,50,833,872,856.5486341,83.3125,39,524,545.6662212,113.18359380000001,40,3930736,46955236,19056104
4642,0,-30,0,12.05456345,48.41308594,6.957951274,30,833,872,852.5291051,102.9052734,39,584,606.1326432999999,122.90527340000001,49,9300,46515576,23513394
9726,0,292,343,310.41733500000004,94.16381836,9.703804324,51,970,1009,988.1226201999999,118.80859380000001,39,89,117.9509299,146.532959,59,6166971,62488724,890395
5191,0,-131,-80,105.4981487,134.3708496,11.5918441,51,1009,1049,1027.793328,89.0625,40,128,156.42070669999998,141.18652340000003,60,712311,67606984,1565916
3715,0,-1696,4545,746.5942045,529909.1211,727.9485704,6241,-156,2460,1119.20208,195411.6306,2616,-861,318.0048398,39708.29858,1504,35673786,80167251,6472133
4286,0,-111,-60,90.50923641,139.66381840000003,11.81794476,51,1000,1029,1012.10561,55.63452148,29,217,236.50502110000002,135.32714840000003,40,524283,65558897,3579816
10414,0,303,353,329.4279132,117.1875,10.82531755,50,931,970,950.3254212000002,83.95214844,39,247,278.18243789999997,153.58496090000003,59,6945456,57799578,4952670
8985,0,-454,1383,451.2478186000001,107950.3711,328.5580179,1837,647,1254,972.6412815,19504.49609,607,-99,348.0759615,16888.42871,782,13031974,60545988,7754040
9456,0,-1000,1696,512.9754807,235129.4531,484.9014881,2696,39,2254,1260.237409,221089.3044,2215,-2059,430.8669494,159599.3943,2811,16841206,101644693,11881365
4219,0,-373,-333,352.9654728,85.91308594,9.268931219,40,872,921,901.9541111999999,86.33496094,49,366,392.07728030000004,109.58984380000001,49,7973416,52065358,9838374
4419,0,-60,-20,44.51123454,94.43359375,9.717694878,40,1000,1058,1024.249908,127.83984380000001,58,158,193.06253030000002,138.64624019999997,59,126800,67141624,2385481
1553,0,-4707,3656,1222.597625,1287364.332,1134.6207880000002,8363,88,1980,1089.542966,218417.3271,1892,-633,385.96781760000005,101868.5928,2197,95663677,75974648,9534154
5941,0,-2292,1676,601.4360159,319789.9209,565.4997089999999,3968,362,2029,1150.904542,109453.9705,1667,-970,424.2630558999999,74850.94507,1870,23150418,84773201,11519945
7314,0,-494,-474,484.6471655,21.484375,4.635124053999999,20,813,843,827.875821,53.10058594,30,386,396.8678936,68.76464844,29,15032504,43864216,10080264
846,0,-4101,1101,986.7154478,814854.9336,902.6931558,5202,-19,2058,1084.736834,212759.5771,2077,-1811,665.2102699,309131.3806,4959,62310872,75305856,28320301
5420,0,626,666,644.5059154,88.18359375,9.390612001000001,40,578,617,592.6244727000001,91.96655273,39,524,556.5954545,106.25,50,26584824,22477041,19827104
1182,0,-757,575,301.2751027,61214.92871,247.41650860000001,1332,156,1823,1054.276811,128737.1631,1667,128,407.26851170000003,11823.656009999999,525,5809068,71135974,10615529
4185,0,-343,-303,320.9219142,70.21484375,8.379429799,40,882,931,909.0181087000001,118.1384277,49,376,402.85339689999995,95.88256836,49,6591416,52884091,10386615
7938,0,-343,515,173.0416767,23929.90405,154.6929347,858,460,1401,1027.9047560000001,51393.95996,941,-59,220.5647935,6911.614990000001,524,1916379,67621644,3113525
7568,0,-282,1040,274.38385519999997,52020.717769999996,228.08050719999997,1322,362,1725,1103.511051,77613.21068999999,1363,-19,232.16915299999997,10774.907959999999,424,4818336,77935145,3449761
8687,0,-373,1202,420.4858982,118719.8591,344.5574831,1575,460,1696,1110.596419,62835.65234,1236,-782,229.9741494,29921.65405,1237,11315737,78939162,3384839
1624,0,-4989,1080,1017.9797550000001,898386.6006,947.8325805,6069,-666,3843,1329.983664,523574.9158,4509,-3415,772.5291762,567039.6873,5484,66322098,113206819,38195285
9220,0,-565,1101,328.7464829,71234.24609,266.8974449,1666,666,1509,1001.2744460000001,19942.976319999998,843,138,324.582424,4963.788086,515,6916752,64163233,6742640
995,0,-656,1181,353.649544,85864.0,293.0255962,1837,401,1382,952.4914042000001,23757.37109,981,79,376.89004950000003,9766.14624,505,8004352,58063352,9090951
609,0,-3080,222,725.3456504,369087.4834,607.525706,3302,117,2009,1002.8879699999999,101739.8711,1892,-198,556.8680975999999,127893.1521,2227,33672084,64370194,19846533
4190,0,-383,-323,351.4438077,114.23339840000001,10.68800255,60,872,921,904.1459022,94.30371094,49,366,390.2508608,110.4099121,49,7904816,52318708,9746927
2391,0,-737,828,292.2929823,66468.7334,257.8153087,1565,833,1225,989.2090433000001,6523.397461,392,-39,293.3288204,15111.126709999999,543,5467852,62626210,5506675
6724,0,90,131,107.11646699999999,111.70996090000001,10.5692933,41,990,1039,1015.115264,107.12109380000001,49,188,208.40731599999998,124.0974121,49,734332,65949376,2779751
790,0,-4656,2101,1024.331871,866953.4678,931.1033604,6757,-1254,4539,1188.205692,439544.3259,5793,-2881,557.8173144,212917.0898,4029,67152370,90357297,19914250
3666,0,-141,-111,127.51372479999999,67.1875,8.196798155,30,931,970,950.4778239,76.65234375,39,376,413.83297880000003,133.314209,79,1040624,57818118,10960495
8200,0,-525,949,309.26770869999996,65798.55443999999,256.5122891,1474,490,1558,1099.31139,66526.14063,1068,-554,217.67152000000002,19444.9021,1039,6121377,77343074,3032377
8544,0,-555,919,327.92908439999997,70246.25366,265.0400982,1474,735,1362,1043.649853,12960.8689,627,-1128,414.4450733,156326.6563,1939,6882399,69709121,10992942
1000,0,-989,939,314.6665398,60304.46875,245.5696821,1928,568,2392,990.8085004000001,54362.57788,1824,-524,441.36073330000005,46971.06226,1850,6336962,62828895,12467155
2170,0,-4989,2565,1094.132012,1112234.574,1054.625324,7554,-39,2882,1429.993805,476517.4131,2921,-1930,450.1044497,127612.1736,2969,76615991,130872466,12966017
423,0,-1202,1919,464.4086966,176804.8506,420.48168880000003,3121,362,1941,988.5567605,76109.57715,1579,-782,573.7163933999999,159457.9961,3524,13803228,62543646,21065632
9601,0,212,262,235.2902463,77.734375,8.816709987000001,50,990,1029,1008.120335,85.10327148,39,79,101.7502303,66.71264648,49,3543136,65043623,662599
1805,0,-4131,3393,1353.821616,1692769.906,1301.0649119999998,7524,-460,3156,1529.880372,642358.4646,3616,-1683,509.8175838,217953.0068,2900,117301310,149794173,16634494
325,0,-5000,1717,1070.534234,957294.0291,978.4140376,6717,-441,2627,1080.4124140000001,227088.0427,3068,-1356,475.66389460000005,82840.08374,2326,73346787,74706623,14480393
8645,0,-494,828,407.29076299999997,94905.15015,308.06679489999993,1322,500,1852,1117.96448,71907.43921,1352,-960,272.1099847,68196.37402,1712,10616689,79990053,4738806
7385,0,-1101,545,235.31016769999997,40782.76465,201.9474304,1646,833,1441,1071.15338,9013.933594,608,-495,222.464639,11190.80249,910,3543736,73431652,3167393
8445,0,-1292,737,324.37478319999997,104121.7344,322.67899589999996,2029,382,1882,1190.841831,125655.0271,1500,-881,215.7197256,24815.60938,1306,6734016,90758673,2978240
3690,0,-3555,4414,857.4390193,715139.6052,845.6592724999999,7969,-215,2431,1095.783902,188297.6306,2646,-950,363.1065615,77673.8125,2266,47052907,76847511,8438168
8025,0,-626,868,346.43783260000004,68312.67554,261.3669366,1494,490,1490,1083.047494,69966.8125,1000,-425,222.32289300000002,16098.40234,811,7681227,75071480,3163358
6112,0,-959,1757,434.85522019999996,154223.5,392.7129995,2716,323,1549,1015.029733,85835.45483,1226,-1128,427.3965153,96855.40234,2157,12102340,65938263,11690738
5153,0,-1787,2070,426.38811910000004,174413.5154,417.6284418,3857,225,2500,1078.799796,134725.5586,2275,-1742,412.0093104,135624.8826,2474,11635637,74483776,10864107
9595,0,202,252,230.4952548,98.60839844,9.930176153,50,990,1029,1008.006084,106.7634277,39,79,97.72873809999999,111.56933590000001,49,3400196,65028881,611258
1330,0,-242,-151,199.27818969999998,452.08959960000004,21.26239873,91,833,931,884.2867005,341.2099609,98,475,524.2427872999999,549.1708984,89,2541555,50045630,17589152
4314,0,-111,-70,93.91052923,94.45996094,9.719051442,41,990,1029,1011.571426,81.28027344,39,217,235.88450559999998,137.08496090000003,50,564428,65489712,3561056
5137,0,-191,-141,167.6055638,66.77246094,8.171441791,50,1009,1058,1024.360372,130.0837402,49,59,73.16761579,60.9375,30,1797864,67156107,342624
4078,0,-171,-101,143.63060259999997,261.1083984,16.15884892,70,960,1009,984.1127111,129.5759277,49,277,319.0404314,274.86303710000004,89,1320304,61982581,6514355
4557,0,464,494,479.8815609,96.26464844,9.81145496,30,892,921,911.8380304,46.55859375,29,89,111.3410442,107.0270996,49,14738324,53212710,793397
2014,0,-666,-636,653.0831207,67.74902344,8.230979494,30,715,754,734.9845449,115.08496090000001,39,306,345.3554329,202.2460938,70,27297124,34572946,7633304
4879,0,-2353,1050,753.1307780000001,535276.7461,731.6260972,3403,303,2313,1275.12878,207397.9678,2010,-534,353.6979865,61558.88452000001,1563,36301182,104061018,8006545
9381,0,-2292,1515,582.0047787999999,316500.6162,562.5838748,3807,254,1921,1159.730592,89069.59546,1667,-356,223.94056129999998,21100.43359,761,21678692,86078403,3209560
8450,0,-757,1888,541.8694204,252793.2148,502.7854561000001,2645,343,2088,1258.977344,183204.9529,1745,-801,245.8785269,41282.655269999996,1761,18791838,101441533,3869200
2752,0,-3858,4898,1174.672381,1274788.058,1129.065126,8756,176,2794,1335.226613,399743.8572,2618,-1128,400.1891545,99227.23608,2048,88310733,114101127,10249687
7189,0,-686,-484,595.888609,3119.132568,55.84919488,202,715,813,767.7244175,1063.842773,98,247,397.6839394,6965.204834,277,22725327,37721650,10121761
1147,0,-3141,828,979.7121388,797980.5273,893.2975581000001,3969,156,4656,1244.3360050000001,437060.8086,4500,-2792,590.2160754,225756.5583,4029,61429496,99095814,22294721
2645,0,-585,-545,564.438327,71.484375,8.454843287000001,40,754,803,777.3134522999999,74.35131836,49,386,409.72578480000004,108.17871090000001,49,20389800,38669837,10744014
565,0,-323,0,150.349021,5480.6521,74.03142643,323,941,1058,1002.558695,681.5146484,117,168,255.14043309999997,1174.579834,148,1446709,64327932,4166185
4097,0,-888,676,221.67952659999997,47511.67188,217.9717226,1564,588,1362,1010.8156439999999,27458.8396,774,-594,402.16416499999997,37446.71655,1395,3145076,65391889,10351105
7498,0,20,60,41.34458852,84.27734375,9.180269263,40,1019,1058,1035.429183,112.203125,39,39,63.13477647,145.87402340000003,60,109400,68615270,255104
5841,0,80,131,104.1759329,127.43359380000001,11.28864889,51,990,1039,1012.3375869999999,82.42749023,49,188,212.61673259999998,116.00683590000001,49,694568,65588953,2893176
8530,0,-565,636,232.7718505,46175.28101,214.8843433,1201,382,1813,1113.464266,97208.69702,1431,-306,200.798134,11890.76929,781,3467695,79347371,2580473
9771,0,292,333,312.92760739999994,91.57714844,9.569594999,41,950,1000,982.0904044,116.18652340000001,50,108,134.00186570000002,184.2773438,60,6267116,61728100,1149216
1257,0,-484,-111,297.9661264,6468.616211,80.42770798,373,852,1186,978.7702744,4255.897461,334,99,220.7195265,3487.7829590000006,227,5682164,61311440,3117895
4004,0,-10,40,19.48557159,78.88183594,8.881544682000001,50,872,911,886.3233221,74.57714844,39,534,557.9919914,95.67871094,50,24300,50276418,19926724
73,0,-3030,909,887.3860402,637334.0603,798.3320489,3939,156,4382,1189.332034,350969.6709,4226,-1920,521.8604489,151592.9373,2979,50397055,90528684,17429653
1357,0,-181,-90,135.2001988,465.1865234,21.56818313,91,990,1078,1030.2276140000001,275.8037109,88,19,66.3777071,349.9023438,80,1169862,67927612,281984
6599,0,-1292,1737,580.1073042,296630.6638,544.6381035,3029,294,1950,1154.684663,151082.1775,1656,-1158,428.4396836,88272.58984,2078,21537567,85330987,11747876
1638,0,-3767,787,836.180425,516908.7322,718.9636515,4554,401,1656,963.8639847999999,47958.225589999995,1255,-663,442.71320779999996,141684.1384,2148,44748653,59458162,12543679
7736,0,30,111,84.75479337,258.0146484,16.06283438,81,1000,1049,1024.3704089999999,86.62670898,49,148,182.76889440000002,314.5849609,69,459736,67157423,2137886
5919,0,-1333,2161,578.9387381,295780.2178,543.856799,3494,352,2009,1133.585524,129491.9197,1657,-326,414.9162943,69995.39063,1434,21450884,82241033,11017954
8727,0,171,212,194.9305966,82.54589844,9.085477337,41,980,1029,1003.359108,93.52734375,49,188,203.8953086,78.33374023,39,2431868,64430688,2660691
7967,0,-777,939,334.92366200000004,83289.79467999999,288.59971360000003,1716,421,1500,1109.2252429999999,76065.42554,1079,-732,229.92811380000003,22503.875,1197,7179127,78744361,3383484
3176,0,-70,-20,47.31873308,85.52246094,9.247835473,50,921,960,940.1163823999999,101.3085938,39,425,454.03400199999993,115.99121090000001,50,143300,56564404,13193400
8883,0,-10,141,78.45709417,982.7595215,31.34899554,151,931,1039,985.608608,614.3962402000001,108,297,336.65503019999994,304.06811519999997,89,393953,62171157,7253543
1529,0,-171,80,110.3565953,1124.0271,33.52651338,251,1009,1068,1031.362388,167.35839840000003,59,39,77.34419823,258.2568359,79,779429,68077336,382856
10188,0,-121,424,253.7827257,13675.14819,116.94078929999999,545,735,1176,1003.150249,9651.376709,441,-405,177.87254040000002,30113.982180000003,642,4121963,64403867,2024873
3621,0,-151,-111,126.44069760000001,71.85058594,8.476472494,40,892,931,914.9992315999999,112.96484380000001,39,465,490.8518106000001,99.9375,49,1023184,53582310,15419872
1746,0,-202,-151,178.7488199,127.9255371,11.31041719,51,980,1039,1007.710377,203.5505371,59,158,203.8983739,270.33569339999997,79,2044873,64990733,2660771
4398,0,20,90,58.77658973,237.67089840000003,15.41657869,70,1000,1039,1026.777575,120.79589840000001,39,128,169.168047,188.7067871,89,221100,67473420,1831541
4427,0,-90,-40,66.09652033,103.0273438,10.15023861,50,1000,1049,1024.525065,83.37475586,49,158,182.94235769999997,104.6005859,49,279600,67177703,2141946
3932,0,111,222,153.2943961,361.90991210000004,19.02392999,111,980,1029,1005.2473960000001,151.829834,49,178,237.72887000000003,323.79467769999997,99,1503947,64673429,3616961
6695,0,80,111,99.40644157,83.73413086,9.150635544,31,990,1019,1006.453698,64.05639648,29,237,252.88386659999998,130.859375,40,632425,64828739,4092816
1346,0,-191,-20,116.7121861,785.5524902000001,28.02770933,171,1000,1078,1032.304317,208.91186519999997,78,29,69.18803636,220.18139649999998,79,871791,68201741,306367
10033,0,10,60,32.83481384,120.99609380000001,10.99982244,50,1009,1049,1027.643725,102.7099609,40,148,171.2552919,151.4648438,50,69000,67587304,1877016
4836,0,-252,-181,219.5057659,317.5458984,17.81981758,71,980,1068,1004.358066,154.29589840000003,88,158,185.98790280000003,146.45996090000003,49,3083698,64559048,2213856
6823,0,-1343,2707,629.7841147999999,346591.9336,588.7205904,4050,352,1950,1012.0812789999999,78035.55443999999,1598,-643,452.3939448,126225.2773,2336,25384194,65555745,13098258
8916,0,-545,2707,538.2866482000001,249017.9236,499.0169572,3252,450,1901,1003.8372,61264.163089999995,1451,-89,346.0303455,17396.99121,920,18544161,64492104,7663168
5878,0,90,131,111.1067898,65.30859375,8.081373259,41,990,1039,1012.6550269999999,92.45678711,49,188,209.22647719999998,94.71875,49,790062,65630093,2801646
9743,0,282,323,308.6536034,104.4372559,10.21945477,41,970,1009,985.3519438,108.5212402,39,108,131.56367279999998,115.234375,40,6097091,62138781,1107776
5324,0,-40,-10,31.29996006,70.28808594,8.383799016000001,30,862,901,881.4066616,83.35522461,39,544,561.4362719999999,103.8818359,50,62700,49720173,20173484
5927,0,-1898,1606,577.8145517999999,301559.5938,549.1444198,3504,294,2088,1133.547591,132896.8767,1794,-613,419.374348,73254.72559,1583,21367658,82235529,11255990
5417,0,626,666,646.0725578,93.75,9.682458366,40,568,617,591.8585135,91.45214844,49,524,553.7889941000001,112.40234380000001,60,26714224,22418976,19627664
8313,0,-494,1242,348.9761811,103677.3086,321.98960939999995,1736,352,1558,1064.191925,67383.70092999999,1206,-336,236.1092504,21816.78687,920,7794200,72480285,3567845
2395,0,-1858,909,598.7759127999999,265602.8818,515.366745,2767,156,2078,1140.136875,175782.0313,1922,-138,346.1167162,31420.63965,791,22946086,83194374,7666994
6753,0,-1020,858,328.324368,106320.6501,326.0684746,1878,460,1852,1105.807221,98712.67943999999,1392,-792,386.2253835,67007.19897,1702,6899001,78259815,9546883
5232,0,-161,-60,120.7305885,526.2177734,22.93943708,101,901,970,936.1569296,206.04467769999997,69,396,448.7829201,295.90405269999997,79,932856,56088947,12889991
1406,0,-2656,575,781.6389332,493877.8298,702.7644199,3231,166,1941,1124.84169,167390.5369,1775,-1821,426.31324680000006,145303.7537,3009,39101403,80977205,11631551
759,0,-1050,545,330.134679,68851.28809,262.3952898,1595,264,1764,967.4283888,87561.55859,1500,-653,390.4445983,52284.62476,1227,6975290,59898732,9756607
3993,0,-10,30,17.00183814,59.35058594,7.703933147000001,40,872,901,886.9063947999999,83.40209961,29,534,555.043692,117.87109380000001,50,18500,50342589,19716704
2262,0,-232,-151,186.1549674,365.048584,19.10624463,81,950,1019,983.2748932,264.0270996,69,217,305.4355497,1425.053711,149,2217835,61877089,5970616
294,0,-292,-20,189.92589019999997,3356.078125,57.93166772,272,931,1049,980.5380937000001,718.048584,118,237,318.71977799999996,1063.575928,188,2308598,61533117,6501267
1048,0,-30,50,19.44543648,335.0585938,18.30460581,80,950,1019,985.7811465,184.6210938,69,237,349.61206180000005,2599.078125,228,24200,62192926,7822630
3558,0,-181,-151,164.3616439,77.734375,8.816709987000001,30,882,921,903.4162593,74.546875,39,465,499.7801704,155.078125,59,1728944,52234300,15985934
1815,0,-3939,2606,1033.329933,984646.6523,992.2936321000001,6545,-215,3029,1478.934419,545925.7146,3244,-1049,496.5975641,188881.5701,2346,68337328,139983809,15782985
7724,0,-727,1343,413.4456585,125421.7568,354.14934260000007,2070,843,1725,1117.5515369999998,25892.80371,882,-376,221.5690144,16337.48413,900,10939988,79930972,3141941
2247,0,-171,-80,126.8594202,616.3974609,24.82735308,91,980,1029,1011.0040650000001,134.5898438,49,168,232.1161482,1078.483398,129,1029972,65416270,3448186
1121,0,-30,20,11.31923142,99.90234375,9.995115995,50,960,1000,980.0478304999999,93.75,40,316,360.1588625,541.5537109,89,8200,61471600,8301722
8220,0,-919,1878,529.7959218000001,238709.9531,488.57952589999996,2797,382,1696,1118.745265,93007.82813,1314,-435,270.4950901,31768.06152,1197,17963758,80101822,4682726
9886,0,303,333,319.36010239999996,70.3125,8.385254916000001,30,960,1000,980.5204294,101.3427734,40,108,135.2553141,102.734375,50,6527416,61530900,1170816
33,0,-151,-20,88.49073045,448.0407715,21.166973600000002,131,960,1029,986.4021349999999,207.64624019999997,69,306,329.84191289999995,163.64746090000003,50,501159,62271307,6962924
6663,0,70,111,92.41220496,67.38842773,8.209045482999999,41,970,1019,997.8117699,92.08569336,49,257,286.6125433,118.20996090000001,49,546561,63720213,5257392
1817,0,-3515,3080,937.0734946,842379.8279,917.8125233,6595,-176,2833,1358.733153,463400.2725,3009,-930,431.53054280000003,117402.5642,2108,56198831,118153970,11917991
5389,0,-70,-30,45.4835135,71.77734375,8.47215107,40,852,892,873.4543133,83.95996094,40,544,570.6671534,119.43359380000001,50,132400,48827036,20842304
10043,0,70,121,102.05926590000001,101.1523438,10.05745215,51,1000,1039,1024.273676,112.51464840000001,39,128,161.30212340000003,157.7148438,60,666630,67144740,1665176
1297,0,-252,-171,218.76460669999997,354.38842769999997,18.82520724,81,823,941,876.5017024,687.5974121,118,455,530.448189,2228.163086,178,3062909,49168335,18008018
752,0,-2828,1151,917.4877127999998,692485.988,832.1574297999999,3979,68,2176,1069.074607,184571.2947,2108,-2128,612.4462859,245591.6833,3573,53874157,73146913,24005789
4715,0,-90,-50,70.86518892,78.02734375,8.833308766,40,843,892,864.1459927999999,117.2907715,49,554,584.0477827000001,128.8085938,49,321400,47791891,21831156
9865,0,292,343,317.51294260000003,107.41308590000001,10.36402846,51,960,1009,981.895186,101.0068359,49,99,138.3469936,134.6833496,59,6452126,61703562,1224953
8037,0,-717,1616,404.4412813,101665.0898,318.8496352,2333,617,1421,1063.174066,34064.655269999996,804,-574,260.84750690000004,30083.423580000002,1138,10468656,72341702,4354651
7981,0,-343,909,273.64943930000004,59612.46265,244.1566355,1252,598,1441,1075.721451,34272.157960000004,843,-19,214.6651098,7179.710693000001,434,4792577,74059305,2949191
1921,0,-252,-101,178.2513149,940.3662108999999,30.66539109,151,960,1029,1003.63273,203.68652340000003,69,178,228.6776183,728.9782715,119,2033506,64465834,3346781
8958,0,-353,1505,409.30573839999994,95824.38965,309.555148,1858,598,1176,1002.3506359999999,14775.07593,578,-346,340.32500550000003,12970.61499,949,10721996,64301235,7412551
6862,0,-10,212,141.3651632,3331.013428,57.71493245,222,950,1039,997.1688437999999,430.16967769999997,89,188,278.0697698,1912.488037,158,1278983,63638125,4948659
7178,0,181,222,198.31185980000004,86.45996094,9.298384856,41,970,1000,986.28723,73.4375,30,247,269.5162333,92.94433594,40,2516966,62256800,4648896
9681,0,-60,-30,47.38472855,91.77246094,9.57979441,30,1000,1049,1022.6722199999999,96.578125,49,178,200.96664840000003,124.66308590000001,49,143700,66934942,2584806
2795,0,-1868,777,621.0040006,296114.1084,544.1636779,2645,147,2107,1131.836278,152113.906,1960,-316,355.5714371,53792.37476,890,24681342,81987415,8091587
979,0,-444,-252,354.0566913,1880.769287,43.36783701,192,901,1000,950.0031661,451.27319339999997,99,118,246.71529640000003,1971.214844,258,8022793,57760385,3895580
4953,0,-101,-20,65.70542691,231.19702149999998,15.205164300000002,81,990,1039,1013.61969,115.93359380000001,49,188,236.70181659999997,567.5,99,276301,65755192,3585776
4329,0,-2080,2010,705.8292552,487860.9443,698.4704320000001,4090,264,2225,1278.557922,227039.3416,1961,-811,376.04105489999995,66056.625,1949,31884476,104621463,9050040
8844,0,10,141,93.52740240000001,1221.8125,34.95443463,131,931,1039,985.8509332,383.8193359,108,306,340.2256604,323.4375,80,559832,62201732,7408224
2034,0,-666,-636,651.2018216,59.35058594,7.703933147000001,30,715,754,733.6370335,86.43139648,39,326,345.246832,127.24609380000001,50,27140084,34446291,7628504
2577,0,-494,-464,475.31739400000004,64.0625,8.003905297000001,30,764,931,822.9127194,370.6210938,167,396,435.48807029999995,139.282959,59,14459304,43339862,12137591
9876,0,292,343,318.7620341,97.30053711,9.864103462000001,51,970,1000,980.9736872000001,70.99609375,30,118,137.50318180000002,120.99609380000001,40,6502991,61587800,1210056
7556,0,-666,1454,327.1801157,75800.74193999999,275.3193454,2120,705,1598,1042.976353,27253.704830000002,893,-425,196.95284180000002,14896.02515,830,6850997,69619179,2482587
601,0,-3111,1808,830.2066573,551648.4648,742.730412,4919,9,3352,1093.794149,263923.82399999996,3343,-1435,505.71192080000003,102508.9978,2375,44111558,76568681,16367651
5556,0,646,686,663.580063,106.25,10.30776406,40,578,607,593.8720401,70.71484375,29,514,535.8166081,104.85839840000001,40,28181664,22571776,18374364
10781,0,-1535,1383,549.4060145,255608.5303,505.5774226,2918,156,2294,1258.62004,226753.7773,2138,-2128,415.5913896,158477.0017,2880,19318206,101383962,11053837
9078,0,-686,2646,662.4562013999999,333649.3506,577.6238833,3332,401,1696,997.4908207999998,35384.02246,1295,59,371.0102972,15814.91968,594,28086286,63679228,8809513
4396,0,40,90,66.73173908,105.37109380000001,10.26504232,50,1009,1049,1027.1643609999999,80.859375,40,128,153.6450862,149.97558590000003,50,285000,67524264,1510836
10641,0,-292,797,250.85852590000002,59363.6709,243.6466107,1089,696,1352,1032.809835,12865.58984,656,-9,214.2842738,2978.139648,315,4027520,68268554,2938736
6116,0,-1121,505,266.3373976,70820.38257,266.1209923,1626,696,1813,1025.496221,26106.52734,1117,-386,281.5647683,21483.55371,970,4539879,67305120,5073838
7168,0,181,212,198.72197130000004,81.96850586,9.053645998,31,941,1009,986.3034127000001,136.17944340000003,68,247,269.88932919999996,125.75683590000001,50,2527387,62258843,4661776
9664,0,-606,2454,543.9324694000001,245882.3398,495.86524360000004,3060,49,2372,1184.073174,175126.9131,2323,-1514,389.4901315,139095.4834,2038,18935202,89729874,9708964
7963,0,-525,1020,364.5557228,101935.87400000001,319.2739796,1545,450,1872,1116.976527,81574.03809,1422,-1108,284.3396956,47176.8125,1711,8505656,79848740,5174340
595,0,-303,-90,200.964899,1780.781006,42.19930101,213,921,1058,976.8032443,561.8122559,137,247,323.12214700000004,754.1071777000001,129,2584761,61065253,6682107
456,0,-333,-292,309.76669649999997,87.765625,9.368330961,41,803,872,840.3079421,202.4023438,69,495,538.2621486,366.1970215,89,6141146,45191516,18542473
6645,0,111,151,125.34602109999999,70.99609375,8.425917977000001,40,980,1019,997.4827223,90.21484375,39,257,276.92967860000005,142.720459,49,1005544,63678194,4908163
3044,0,0,50,27.95084972,140.5273438,11.85442296,50,960,1009,985.5081256000001,108.4040527,49,316,340.120475,145.67871090000003,60,50000,62158481,7403644
2153,0,-3131,4898,1247.051341,1417113.187,1190.425633,8029,29,2901,1461.222252,486915.6943,2872,-1821,503.0081386,144323.3398,2959,99528771,136650910,16193100
3045,0,0,30,16.723860199999997,77.51464844,8.804240367,30,970,1009,985.4810215,85.77734375,39,316,344.0054505,132.7148438,60,17900,62155062,7573744
2796,0,-3888,2727,890.1723411,755895.947,869.4227666000002,6615,29,2000,1136.322949,146664.1943,1971,-316,488.4053291999999,138851.5701,2415,50714035,82638710,15266545
5061,0,-2727,969,674.6843822000001,435951.7888,660.2664529,3696,68,2362,1305.004292,321933.8181,2294,-1722,409.8080534,132592.7654,2514,29132737,108994317,10748329
348,0,-2464,181,599.5370349,231235.9023,480.86994330000005,2645,166,1862,939.0345191,57747.39819,1696,-792,479.38391449999995,97017.02246000001,1801,23004458,56434293,14707772
8609,0,-767,1888,382.49046150000004,123897.28300000001,351.9904586,2655,500,1460,1071.549047,47914.70093,960,-356,211.4780943,21404.739990000002,811,9363133,73485911,2862271
9074,0,-404,1222,375.2466689,94437.13184,307.30625089999995,1626,313,1392,995.7186004,35704.89063,1079,-267,340.7611884,11182.68359,742,9011844,63453154,7431564
1348,0,-191,-60,128.9841318,372.6865234,19.30509061,131,1009,1058,1032.126438,164.23217769999997,49,29,59.95623404,187.109375,70,1064762,68178239,230064
4266,0,-383,-343,358.13091180000004,93.75,9.682458366,40,872,911,895.8321202,91.13964844,39,366,402.95930699999997,156.05444340000003,59,8208496,51360972,10392077
2174,0,-4373,5040,1290.0374570000001,1561526.4630000002,1249.610524,9413,-39,3147,1419.5143369999998,465735.0837,3186,-881,409.9343316,83637.74902,1930,106508585,128961341,10754954
6145,0,-20,20,10.75290658,112.109375,10.58817147,40,990,1039,1013.9930119999999,80.88842773,49,207,240.8687402,132.39746090000003,60,7400,65803637,3713136
74,0,-3646,646,913.6559202999999,692013.0486,831.8732167000001,4292,137,3264,1148.054026,234834.9607,3127,-1534,490.4770318,101275.4834,2553,53425097,84353795,15396334
8122,0,-282,1191,376.4620665,95900.93359,309.6787587,1473,431,1735,1128.8467699999999,84014.03125,1304,-554,264.0120736,34016.80371,1177,9070316,81554882,4460952
3669,0,-141,-111,131.352579,51.53808594,7.17900313,30,921,980,952.0297067,116.06152340000001,59,376,416.7298098,152.43530269999997,69,1104224,58007076,11114479
5233,0,-131,-101,115.5546408,77.51464844,8.804240367,30,931,970,945.5437589,82.75,39,415,430.89296809999996,96.26464844,40,854584,57219392,11882800
6131,0,-20,30,11.03970108,99.90234375,9.995115995,50,990,1039,1015.5589359999999,87.96850586,49,198,226.47609559999998,109.42944340000001,49,7800,66007037,3282651
7524,0,60,292,160.2670135,2338.630615,48.35939015,232,901,1147,1015.673999,2288.310303,246,-257,230.8926969,21169.6709,771,1643873,66021995,3411932
6884,0,-1010,707,229.41862659999998,48556.881839999995,220.35626119999998,1717,774,1470,1023.15071,10767.85938,696,0,286.1464878,9938.514648,534,3368506,66997592,5240308
5508,0,646,696,666.0563039,75.0,8.660254038,50,578,617,595.2716817,63.01464844,39,504,525.9607875,90.234375,40,28392384,22678296,17704624
284,0,-5000,2474,880.1663815999999,733325.113,856.3440389,7474,-303,3833,1330.33394,566345.1091,4136,-1663,480.78581510000004,167146.0,2375,49580343,113266457,14793920
6289,0,-646,3121,586.8844781,321457.4626,566.9721886,3767,284,1764,1070.15199,114619.6211,1480,-465,496.55200189999994,141009.9724,2346,22043737,73294418,15780089
6767,0,-1646,2030,669.2135193,409105.4236,639.6134955,3676,450,3352,1159.847283,195860.71,2902,-3861,718.2937682,416247.875,5484,28662191,86095726,33020540
5929,0,-2161,2020,656.6480341,386553.4763,621.734249,4181,372,2009,1164.282941,128825.4626,1637,-930,451.64001500000006,89153.0271,1949,27595945,86755505,13054637
4877,0,-2161,1292,750.5733329,544698.2068,738.0367246000001,3453,117,2490,1350.527582,310717.2344,2373,-970,375.5118382,66999.63842999999,2168,36055061,116731184,9024585
803,0,-4898,1292,1035.842577,920625.9961,959.4925722000002,6190,78,1539,1027.943434,89180.30054,1461,-1435,420.85710539999997,69649.42358,2563,68670070,67626733,11335725
9570,0,-1323,2272,709.0022809,461100.1033,679.0435209,3595,19,2019,1238.394267,225063.1033,2000,-2069,400.85728450000005,134805.7969,2930,32171791,98151703,10283940
9496,0,-1292,2505,682.6699537000001,431413.19700000004,656.8205212,3797,9,2127,1235.055091,218447.6931,2118,-2000,401.982198,133919.4443,2792,29826449,97623109,10341740
6302,0,-1222,1333,493.96487410000003,216315.4568,465.0972552,2555,284,2039,1133.020286,145512.7031,1755,-1198,390.6841355,83530.82813,1950,15616083,82159038,9768582
8073,0,-80,989,208.0164882,23217.64429,152.37337130000003,1069,568,1196,1005.1367439999999,22512.35938,628,0,181.91279680000002,3125.409912,267,2769335,64659192,2117905
2863,0,-3303,2575,997.731419,865225.9412,930.1752207000001,5878,421,1833,1062.423608,92324.48217999999,1412,-455,339.61089869999995,51326.5625,1355,63709951,72239611,7381476
1438,0,-1757,949,672.7143246,341155.5,584.0851821,2706,254,1950,1137.194176,164901.9209,1696,-1118,350.0567811,98262.21484,1830,28962852,82765478,7842544
314,0,-646,181,294.2325292,25440.21875,159.499902,827,676,1431,960.6476412000001,19720.34546,755,-237,365.02934389999996,25857.083740000002,890,5540658,59062009,8527771
772,0,-1515,525,542.0797623999999,166222.9063,407.70443489999997,2040,264,2147,997.0092463999999,94671.56934,1883,-227,354.14097210000006,57221.4021,1236,18806430,63617756,8026613
4714,0,-90,-60,69.86594306,68.359375,8.267972847000001,30,852,892,864.5451839,78.125,40,554,581.6955684999999,100.2692871,49,312400,47836056,21655663
95,0,-2787,404,801.1407297000001,442073.3398,664.88596,3191,107,1539,949.1088419,106035.3438,1432,-831,392.2901907,61057.12109,1692,41076894,57651686,9849062
6500,0,-1929,1535,583.6035951,310110.1787,556.8753709,3464,284,2127,1177.423219,179073.875,1843,-366,436.37961900000005,78902.48217999999,1286,21797962,88724828,12187339
3138,0,-1757,5101,1254.486243,1509338.7419999999,1228.551481,6858,-862,3509,1270.307947,622724.249,4371,-1396,398.95938860000007,115826.5586,1990,100719087,103275666,10186790
2730,0,-585,-555,569.2703663,58.76464844,7.665810358,30,754,794,771.5445547999999,68.75,40,376,407.544687,151.0114746,59,20740400,38097984,10629931
8518,0,-636,2070,586.4604099999999,294373.9219,542.5623668,2706,333,2137,1225.9308130000002,179723.4587,1804,-1564,319.79549130000004,75984.64063,2593,22011892,96186007,6545226
4071,0,-444,-424,433.8887386,39.03808594,6.24804657,20,882,941,913.4946292000001,161.45996090000003,59,227,264.8730828,114.81933590000001,60,12048604,53406236,4490096
3075,0,-4676,5030,1097.760732,1194092.965,1092.745608,9706,-215,1990,1131.123626,219892.1006,2205,-851,371.91461969999995,48816.67358,1415,77125032,81884202,8852511
1589,0,-4969,878,947.6813728,783887.6697,885.3743105000001,5847,-29,3774,1054.913548,309242.4023,3803,-1356,388.6856659,112236.7595,3088,57478399,71221926,9668899
9713,0,272,323,298.5415329,127.376709,11.28612905,51,970,1009,988.2881507000001,75.40625,39,99,121.84691979999998,126.157959,49,5704131,62509662,950187
4552,0,454,494,481.1114086,77.12402344,8.782028435,40,892,931,911.8874314,79.66308594,39,89,109.75370149999999,110.3125,49,14813964,53218476,770936
8706,0,-252,-222,237.34916260000003,165.625,12.86953768,30,980,1000,986.7362552999999,34.54589844,20,198,222.8622753,91.78808594,39,3605416,62313500,3178726
6357,0,121,171,150.5440135,97.82714844,9.890760761000001,50,960,1000,979.5718132999999,79.46777344,40,297,322.6258718,131.5876465,49,1450464,61411900,6661597
10196,0,272,313,292.363777,112.173584,10.59120314,41,911,960,938.8115075999999,86.14819336,49,336,353.6723413,121.875,40,5470501,56407491,8005384
5706,0,-1969,909,619.0393515,344707.9209,587.1183193,2878,78,2166,1266.355407,269594.9216,2088,-1217,392.36108210000003,102190.9688,2256,24525422,102633985,9852622
9827,0,303,333,319.3698874,76.5625,8.75,30,960,1000,981.4490243999999,83.95996094,40,118,134.0554922,115.234375,40,6527816,61647500,1150136
5689,0,-2080,1404,663.3801112000001,396228.73799999995,629.4670269999999,3484,-58,2323,1288.226209,302702.2048,2381,-821,363.7414088,92507.5625,1791,28164683,106209713,8467700
6051,0,50,101,75.50889848,95.328125,9.763612293,51,1000,1039,1015.701251,91.41308594,39,188,216.04708689999998,155.2460938,59,364902,66025538,2987286
4941,0,353,767,535.0571377,8672.409912000001,93.12577469,414,725,901,838.9865352,1130.5585939999999,176,237,322.68429810000003,1865.108398,159,18322313,45049498,6664010
1564,0,-3555,1252,939.1274874,670130.375,818.6149125,4807,-39,1843,1087.573151,178717.4197,1882,-2188,510.5127784,213717.2126,3603,56445468,75700183,16679891
1875,0,-1313,1919,561.3309936,310018.1482,556.7927336,3232,-68,1862,1161.972118,153855.9607,1930,-861,817.0029357000001,454987.2029,3633,20165919,86411469,42719603
7924,0,90,141,111.65495120000001,170.0974121,13.04213986,51,1000,1049,1024.563184,129.46875,49,118,158.9101554,239.03808590000003,60,797877,67182702,1616156
10202,0,262,313,294.37383230000006,100.4743652,10.023690199999999,51,911,960,935.4590785,98.83496094,49,336,355.72645739999996,138.84277340000003,50,5545981,56005356,8098644
7304,0,-505,9218,3292.173456,10324944.25,3213.245127,9723,843,7170,2655.691541,4373951.59,6327,366,5080.064843,21307489.83,13968,693657988,451372644,1651651764
9317,0,-40,161,77.93516937,683.1188965,26.13654332,201,950,1117,1006.324772,936.4645995999999,167,227,276.3178084,451.28125,119,388729,64812131,4886498
12,0,-141,-20,89.71883164,835.0898437999999,28.8979211,121,960,1039,994.3510761,263.1396484,79,237,310.4800718,549.5849609,129,515166,63278980,6169464
1770,0,-191,-151,173.69261640000002,121.06933590000001,11.00315118,40,970,1019,998.8341406999999,74.44311523,49,217,246.53777599999998,157.20214840000003,50,1930824,63850857,3889976
2604,0,-525,-272,472.17030489999996,1648.0563960000002,40.59626087,253,803,980,843.2567539999999,1565.282959,177,188,406.8428367,2910.53125,267,14268467,45509245,10593350
2359,0,-1848,2777,695.2409878999999,442391.7412,665.1253575000001,4625,215,2401,1223.1533470000002,218179.8416,2186,-673,370.2443239,79203.02515,1445,30935042,95750663,8773175
2057,0,-1050,1494,432.33363849999995,168662.0537,410.68485939999994,2544,666,1568,1011.188031,8735.43335,902,-59,219.3142366,11084.58179,732,11962392,65440079,3078319
2618,0,-474,-444,455.47440930000005,62.08496094,7.879401052,30,843,882,865.2166094,104.4443359,39,346,365.6271154,70.09277344,40,13277244,47910386,8555724
6236,0,-2545,1202,511.23192209999996,240119.5701,490.0199691000001,3747,470,1950,1135.369612,93185.21484,1480,-257,342.2079503,44526.55371,1078,16726917,82500106,7494802
1881,0,-3686,2232,920.3651448999999,760047.0,871.8067446,5918,29,3382,1449.59033,554708.9844,3353,-1267,495.99330580000003,172084.8474,2663,54212608,134483976,15744599
9231,0,-373,1161,363.9240134,78398.96777,279.9981567,1534,735,1225,984.7761563999999,8863.382568,490,0,344.14461439999997,7744.146240000001,554,8476204,62066181,7579873
5135,0,-181,-131,157.5011905,177.2460938,13.31338025,50,990,1049,1023.932081,116.890625,59,69,105.984595,211.0153809,69,1587624,67099962,718895
2653,0,-585,-555,568.8090629,67.1875,8.196798155,30,745,794,772.9862244,99.47827148,49,386,407.08944039999994,98.24902344,49,20706800,38240493,10606196
7911,0,111,151,134.88791640000002,79.27246094,8.90350835,40,1000,1049,1025.328476,128.88256840000003,49,89,119.54287930000001,151.80371090000003,69,1164464,67283103,914592
8871,0,30,111,70.3145833,377.3376465,19.42518073,81,950,1029,989.6780411000001,228.6835938,79,297,330.5345339,198.33569340000003,69,316425,62685608,6992197
1882,0,-3141,2747,1013.802681,918358.9648,958.3104741000001,5888,88,3078,1445.198316,499934.8689,2990,-980,530.2435319,193569.9509,2494,65778936,133670283,17994125
5437,0,606,646,625.5847763999999,66.96777344,8.183383983999999,40,558,607,589.5567852999999,85.37475586,49,554,585.4291827999999,118.314209,59,25046804,22244941,21934549
6681,0,80,131,102.8064778,104.5212402,10.22356299,51,980,1029,1005.389135,91.25683594,49,227,258.96959280000004,129.85839840000003,60,676427,64691668,4292176
9525,0,0,60,25.40300179,103.2958984,10.16345898,60,1000,1049,1022.500481,96.84155273,49,188,204.5227295,79.56420898,39,41300,66912463,2677091
4106,0,-1464,3474,506.816504,253092.2412,503.0827379,4938,598,2068,1028.773359,41050.23438,1470,-1881,626.0262325,256760.7031,4930,16439230,67735976,25082166
7762,0,-262,575,213.781869,34611.96484,186.04291130000001,837,529,1450,1069.443795,38123.499019999996,921,-613,211.35940209999998,22064.855219999998,1028,2924972,73197442,2859059
849,0,-4989,1767,1050.917739,996638.9961,998.3180836000001,6756,-147,3058,1095.801683,438461.3474,3205,-2138,529.5986098000001,202092.1865,4276,70683398,76850005,17950380
5264,0,-151,-121,134.69548989999998,69.43359375,8.332682266,30,911,950,931.6541321000001,83.39428711,39,425,456.09415149999995,142.8710938,60,1161144,55550683,13313400
9638,0,-828,2353,546.2018285,261147.7256,511.02614960000005,3181,156,1715,1100.790966,73985.19434,1559,-1524,313.84704669999996,75764.9834,2009,19093532,77551408,6303998
9956,0,292,333,314.99419639999996,94.75683594,9.734312298999999,41,960,1009,983.5938806,92.46655273,49,118,144.5194624,167.8710938,70,6350166,61917243,1336696
1168,0,-343,-262,317.91166719999995,172.2614746,13.12484189,81,852,950,906.4421950999999,320.07006839999997,98,356,412.350579,237.4960938,79,6468341,52584797,10882112
1499,0,-2686,646,762.8751946000001,486921.9648,697.7979397999999,3332,225,1911,1121.713749,152162.2712,1686,-198,374.4676638,77585.32715,1693,37246628,80527471,8974466
4076,0,-191,-131,159.88980580000003,144.4335938,12.01805283,60,970,1009,993.6725442,94.484375,39,257,280.8125209,131.5876465,49,1636144,63192648,5046763
9719,0,272,323,298.0250357,98.71459961,9.935522111000001,51,970,1009,989.2427739,78.44311523,39,89,122.428423,180.8710938,59,5684411,62630481,959278
7787,0,-181,-111,146.9089854,174.9023438,13.22506498,70,1000,1049,1022.978968,84.83984375,49,69,91.25830442,185.83569340000003,59,1381264,66975102,532997
65,0,-949,606,307.88129310000005,43396.583739999995,208.3184671,1555,382,1401,935.4011673,26388.93359,1019,-178,448.1902324,45157.92554,1425,6066617,55998422,12855967
10147,0,-979,3727,947.0790787000001,798735.3037,893.7199245999999,4706,-127,1931,1213.394251,194330.6873,2058,-504,289.1933015,33938.60327,1147,57405362,94228839,5352497
7410,0,-828,1242,433.5308885,146663.8711,382.9671932,2070,215,2019,1184.326549,132641.2461,1804,-683,271.93884310000004,39777.74585,1336,12028738,89768280,4732847
5445,0,606,646,626.8443288,79.07714844,8.892533297,40,568,627,589.2901714999999,84.17089844,59,564,582.7558719,116.10058590000001,49,25147764,22224826,21734682
10066,0,-1080,2090,655.5242177,379185.3896,615.7803096,3170,0,2196,1187.013453,176900.9375,2196,-1841,377.029446,117624.7068,2573,27501568,90176060,9097677
2116,0,-2727,5090,1160.025343,1247425.525,1116.882055,7817,49,2852,1337.937674,460668.2188,2803,-603,405.067722,80802.52515,1880,86122163,114564942,10501111
2059,0,-363,747,233.61520180000002,35185.5,187.57798380000003,1110,872,1343,1016.881238,4615.269287,471,59,229.4290127,5324.624756,436,3492868,66179037,3368811
2994,0,-20,40,20.841665,138.9648438,11.78833507,60,960,1029,996.0783729,156.125,69,267,308.8029307,225.5585938,69,27800,63499016,6102992
6558,0,-1383,1747,487.8700358,215116.9705,463.80704010000005,3130,372,1607,1068.8271320000001,42514.875,1235,-485,516.3338915,148973.124,1900,15233099,73113052,17062444
7222,0,-505,-505,505.0,0.0,0.0,0,843,843,843.0,0.0,0,386,386.0,0.0,0,16321600,45481536,9535744
4345,0,-2373,1343,719.2340001,499877.6716,707.0202767000001,3716,166,2264,1265.960684,245977.4919,2098,-574,343.78663439999997,44443.05859,1643,33107043,102570013,7564112
9172,0,-242,868,293.6234302,62777.02246,250.55343230000003,1110,558,1352,1006.429953,23249.33984,794,19,331.0879792,9189.678711,505,5517742,64825680,7015632
1844,0,-3888,3202,1063.54135,1037474.64,1018.564991,7090,-68,2970,1418.861086,462130.0537,3038,-1099,494.3234328,178579.4365,2504,72391693,128842674,15638762
535,0,-515,-10,376.8531503,11731.138429999999,108.3103801,505,843,1029,904.9509654999999,1776.749023,186,118,376.3537025,5492.640381,426,9089171,52411920,9065095
10131,0,-797,3535,733.5311215,461598.374,679.4103135,4332,333,1715,1116.327671,105897.1943,1382,-1554,451.48479000000003,151975.5701,2494,34436346,79755998,13045665
8474,0,-989,1090,421.91197989999995,124098.6836,352.2764307,2079,529,1352,1065.659823,30142.90015,823,-871,311.5352358,81339.23022,1573,11392622,72680375,6211469
5229,0,-343,-20,214.5269869,5388.087646,73.40359423,323,754,1088,990.1102368999999,4359.522461,334,-158,306.3087189,24738.194340000002,900,2945397,62740370,6004802
8683,0,-313,1333,493.1294518,125891.8115,354.812361,1646,568,1421,1071.799917,50058.02734,853,-237,202.5357993,13733.83984,603,15563306,73520324,2625328
7720,0,-1373,2858,495.63625460000003,229058.6111,478.6006802,4231,568,2078,1070.444059,64022.97241,1510,-514,232.1122775,26862.105219999998,1018,15721939,73334431,3448071
10476,0,90,141,116.6192389,147.67163090000003,12.15202168,51,1000,1049,1020.948257,85.77246094,49,158,181.46457130000002,151.41967769999997,59,870403,66709462,2107481
993,0,-1595,1202,413.08335639999996,125766.7048,354.63601739999996,2797,313,2196,967.5179585000001,49197.9375,1883,-366,443.54296229999994,26354.89819,1078,10920823,59909824,12590743
10304,0,-1040,5111,771.2264077000001,572881.5466,756.8893886,6151,88,3000,1192.214667,257674.25,2912,-1237,287.72523789999997,67129.54688,1831,38066571,90968052,5298292
10273,0,-1272,2050,620.7850624,320540.2031,566.1627002,3322,372,1843,1252.48324,110620.281,1471,-1861,360.4892075,107630.2412,2702,24663942,100397713,8316958
8178,0,-565,858,351.5336044,73203.68359,270.56179260000005,1423,539,1539,1067.647626,47225.896239999995,1000,-851,257.28146069999997,32510.03027,1256,7908856,72951773,4236400
10662,0,-1444,2797,663.3808412999999,396855.6287,629.9647837,4241,-9,3098,1173.328419,258690.7302,3107,-2603,611.7367694,364703.4336,3711,28164745,88108773,23950200
6618,0,-40,10,16.15355998,116.18652340000001,10.77898527,50,1000,1039,1019.386013,86.16308594,39,188,215.55382880000002,177.9645996,59,16700,66505462,2973661
4623,0,-1040,919,347.13476760000003,115374.6443,339.66843289999997,1959,245,1852,1096.2121220000001,104392.031,1607,-534,301.6460312,23577.073969999998,1385,7712163,76907585,5823381
346,0,-2656,1060,761.6678964,448765.7166,669.899781,3716,49,1960,1075.026722,234112.4529,1911,-851,547.2027446000001,143652.6211,2395,37128831,73963677,19163574
3311,0,-80,-40,56.41642048,71.26464844,8.441839162,40,921,960,939.7139607999999,79.09545898,39,425,457.64000589999995,128.125,60,203700,56515989,13403800
7024,0,202,242,227.07088650000003,103.1005859,10.15384587,40,970,1009,989.9932369999999,79.41967773,39,207,224.5821119,107.00683590000001,40,3299916,62725543,3227976
6985,0,60,252,171.64338940000002,1021.792725,31.96549272,192,833,1068,990.4239623,1891.217773,235,227,261.6200728,568.5302734,109,1885533,62780136,4380484
10450,0,40,121,88.09254722,242.86499019999997,15.58412623,81,1000,1058,1024.066229,103.6403809,58,148,173.1570819,162.4023438,50,496659,67117545,1918936
3858,0,-131,-80,111.32567649999999,127.84375,11.30680105,51,950,990,971.4494647,83.95996094,40,336,373.37340980000005,150.454834,69,793178,60397700,8922093
5872,0,70,101,88.29221724,76.24584961,8.731886944,31,1000,1039,1015.622823,59.05371094,39,178,204.6422565,115.6989746,49,498913,66015342,2680221
4802,0,-171,-121,143.519598,95.21484375,9.757809372,50,1000,1029,1011.334947,45.40234375,29,188,209.79979300000002,92.96264648,49,1318264,65459096,2817021
10087,0,-1373,2717,745.4171336,497437.6013,705.2925642999999,4090,68,2392,1253.2606039999998,223793.0916,2324,-1841,441.64230080000004,181631.7673,3237,35561389,100522377,12483067
10519,0,-1070,4737,852.911008,646730.1719,804.1953568,5807,88,3264,1177.377429,231969.5427,3176,-1198,406.67598819999995,132900.9294,2158,46557260,88717927,10584663
7621,0,-828,2151,345.99096810000003,101686.6875,318.8835015,2979,647,2303,1039.877945,37405.00757,1656,-1564,302.1754974,68091.89063,2118,7661424,69206153,5843842
9915,0,292,343,317.8163041,111.6364746,10.56581632,51,970,1000,981.4410642000001,68.33496094,30,108,139.9640579,155.83496090000003,70,6464461,61646500,1253756
2817,0,-2474,636,746.0311865,470511.9756,685.938755,3110,-49,2117,1029.0157390000002,104985.4392,2166,-782,398.53597310000004,79597.46851,1702,35620002,67767897,10165179
7035,0,212,252,230.44779780000002,76.73339844,8.759760182,40,960,1000,987.6906462000002,67.94433594,40,198,228.71963599999998,136.1188965,49,3398796,62434100,3348011
3100,0,-10,40,16.00781059,115.234375,10.73472752,50,990,1039,1009.23859,103.1210938,49,227,259.9163327,135.13183590000003,60,16400,65188002,4323616
770,0,-2111,1525,687.0283951,323602.4919,568.8606963999999,3636,58,3225,1012.95243,176507.1709,3167,-1722,473.47297310000005,121135.6563,3048,30208513,65668648,14347306
420,0,-4969,606,1136.935993,1084159.869,1041.229979,5575,-519,2686,953.7364267999999,188626.4412,3205,-811,615.0571493,155909.3689,2811,82727901,58215243,24210899
2741,0,-585,-555,570.6794196000001,62.109375,7.880950133,30,754,784,769.5153101,71.65527344,30,386,411.5574459,124.42871090000001,49,20843200,37897844,10840290
2250,0,-111,-60,85.22525301,160.01464840000003,12.64968966,51,1000,1039,1019.7473570000001,90.20874023,39,168,199.9265881,176.62475590000003,59,464854,66552619,2558121
5104,0,-1838,909,518.0109344,258512.6599,508.44140260000006,2747,-58,2568,1296.674918,339605.6006,2626,-1841,407.1986232,112276.3281,2603,17173461,107607414,10611886
2010,0,-656,-616,639.1906992,83.984375,9.164298937,40,686,803,743.1482334,475.673584,117,316,357.9650166,299.18530269999997,89,26148144,35345235,8200893
1930,0,-151,-101,123.74520190000001,99.19433594,9.959635332000001,50,990,1029,1010.308678,55.42089844,39,198,218.90640840000003,129.9567871,59,980024,65326312,3066881
967,0,-50,-10,31.47419578,90.625,9.519716382,40,990,1019,1006.14998,50.265625,29,247,271.1634655,139.42871090000003,50,63400,64789618,4705896
2649,0,-595,-545,568.9766032000001,80.05371094,8.947273939,50,754,794,774.6852587000001,93.359375,40,386,406.3435854,114.1306152,49,20719000,38408784,10567367
3039,0,-10,30,16.44118305,85.52246094,9.247835473,40,970,1009,988.2913127,81.65625,39,306,335.6915437,107.59277340000001,50,17300,62510062,7212084
7978,0,-181,535,147.94234519999998,11955.56934,109.3415261,716,813,1382,1028.82319,5672.902344,569,-1336,346.1336221,93009.77124,2345,1400764,67742538,7667743
9467,0,-1050,1656,560.9926749,261510.4756,511.3809496,2706,-58,2254,1180.099393,190013.9177,2312,-2108,478.80438660000004,215502.4138,2909,20141618,89128613,14672233
8941,0,111,171,148.1565895,175.6835938,13.25456879,60,931,1000,966.7421531,196.2927246,69,336,367.64801439999997,177.70996090000003,60,1404824,59813785,8650564
7056,0,212,252,229.36788140000002,82.71484375,9.094770132,40,960,1009,991.0870295,110.56152340000001,49,188,227.21087400000002,152.515625,59,3367016,62864224,3303986
4369,0,-2131,1666,646.0434147999999,410258.2256,640.5140322999999,3797,127,2372,1290.107941,261116.1475,2245,-1009,380.0973148,73351.74609,1989,26711814,106520224,9246334
10537,0,50,101,76.59787448,117.329834,10.83188968,51,1000,1049,1029.693082,75.85058594,49,99,136.56345819999999,200.298584,79,375503,67857142,1193573
9603,0,40,80,58.30951895,93.75,9.682458366,40,1000,1049,1027.497134,90.43530273,49,138,168.9635686,166.96777340000003,60,217600,67568023,1827116
870,0,-4161,1060,770.1548343,494365.7646,703.1114881,5221,19,3892,1151.139646,384677.1169,3873,-1851,456.220821,135826.8662,2603,37960862,84807839,13320796
2954,0,-282,-232,248.70213109999997,69.43359375,8.332682266,50,843,882,857.0728801000001,98.14038086,39,504,544.4415717,140.5273438,60,3958576,47012731,18970664
4615,0,-121,-30,58.39828229,380.20092769999997,19.4987417,91,980,1039,1015.479059,147.86621090000003,59,188,235.2824765,1185.28125,118,218263,65996654,3542902
7330,0,-494,-474,485.60825260000007,44.43359375,6.665852815,20,803,843,826.1815025000001,93.359375,40,396,409.0366159,93.85327148,29,15092184,43684856,10707901
653,0,-191,-50,115.97474129999999,762.2302246,27.60851725,141,931,1009,967.6880308,303.4052734,78,336,381.6759096,372.5898438,89,860809,59930888,9323296
445,0,-353,-272,308.790129,236.92871090000003,15.39248878,81,813,892,850.3443328,240.13061519999997,79,465,527.2673065,775.6552734,129,6102486,46277471,17792692
9001,0,70,212,158.4510966,663.3818359,25.75619995,142,941,1058,990.9320344,825.0935059,117,267,308.4591494,273.42163089999997,69,1606832,62844563,6089411
3953,0,-363,2595,540.0188509,169371.7927,411.5480442,2958,500,1549,1036.4974220000001,60277.90625,1049,-673,251.3620397,53063.77246,1573,18663703,68756922,4043704
5172,0,-5010,5010,1479.680408,2160378.531,1469.822619,10020,-2372,4696,1494.01985,1192715.063,7068,-1386,651.7093269999999,344414.8005,5049,140125063,142854100,27182403
403,0,-5000,1878,1213.5813859999998,1321337.1940000001,1149.4943210000001,6878,-549,3392,1127.7284619999998,479754.9197,3941,-2297,718.6949001,411617.2224,5376,94257906,81393375,33057431
230,0,-606,474,230.4223364,27047.519289999997,164.4613003,1080,676,1715,983.0435599,23260.5271,1039,-1772,490.26469249999997,129345.5586,2544,3398045,61847977,15383006
7038,0,212,252,229.9516253,63.96484375,7.9978024329999995,40,970,1009,990.5606604000001,89.21850586,39,207,228.88506940000002,147.5585938,50,3384176,62797467,3352856
6815,0,-555,404,172.609793,20955.20288,144.75912019999998,959,843,1362,1009.3636449999999,5269.40625,519,-128,303.7671549,17104.267330000002,910,1906825,65204158,5905567
463,0,-333,-292,311.69448680000005,91.99780273,9.591548506,41,813,862,839.5951033,107.21777340000001,49,514,544.1579504,171.875,60,6217821,45114876,18950904
7070,0,212,252,232.90408430000002,57.20214844,7.563210194,40,970,1000,988.6235697000001,58.95996094,30,207,232.11311899999998,124.97558590000001,60,3471636,62552100,3448096
10189,0,-1373,1393,379.1469455,109804.3438,331.3673849,2766,441,1950,1035.702456,38994.333739999995,1509,-1207,255.2355836,48516.29468,1593,9200154,68651493,4169293
5224,0,-1060,646,367.30536939999996,107888.9568,328.4645442,1706,323,1745,1123.707549,102655.0273,1422,-1000,261.0608167,41379.60938,1485,8634447,80813994,4361776
6329,0,121,161,145.3285072,77.24609375,8.788975694,40,950,1000,982.8561695000001,85.83984375,50,297,316.50424560000005,81.796875,39,1351704,61824400,6411196
6158,0,-888,595,262.1512564,61922.18652,248.8416897,1483,656,1431,1016.890135,21683.704830000002,775,-227,291.5659231,22119.45215,830,4398290,66180195,5440684
5756,0,-1696,2090,587.6295336000001,310724.0928,557.4263115,3786,196,1931,1238.687707,153024.49,1735,-1029,335.8335944,71986.51538,1939,22099742,98198223,7218189
9328,0,-10,151,88.20661115,2164.777344,46.527167799999994,161,941,1147,998.9073404999999,2061.359375,206,247,293.0579348,518.548584,99,497946,63860216,5496509
968,0,-40,-10,28.118054700000002,68.359375,8.267972847000001,30,990,1019,1006.645241,72.20678711,29,247,273.8149466,138.1835938,50,50600,64853417,4798376
3441,0,60,161,114.7682447,438.0380859,20.92935942,101,980,1049,1005.631922,202.46777340000003,69,198,243.97909109999998,271.5876465,99,842992,64722916,3809651
8702,0,-323,-262,311.7577685,238.515625,15.44395108,61,950,1000,979.0987564999999,70.99609375,50,178,209.29535800000002,130.07788090000003,49,6220346,61352600,2803491
9462,0,-1363,2070,645.1761751,377215.1814,614.1784605,3433,0,2196,1255.7213689999999,234569.0898,2196,-1811,395.335281,131162.781,2494,26640147,100917514,10002559
10216,0,272,323,298.9685654,83.95483398,9.16268705,51,921,950,932.9586422,68.60327148,29,326,362.1434453,149.1210938,70,5720461,55706357,8393464
4862,0,-2585,1131,713.3096606,491399.0447,700.9986052999999,3716,186,2431,1345.8811699999999,289411.2773,2245,-881,349.38309469999996,63103.048579999995,1811,32563883,115929352,7812387
10096,0,-949,3888,817.1429935,579002.4646,760.9221147000001,4837,68,1656,1103.398181,116725.9236,1588,-584,314.8140324,81034.43359,2098,42734251,77919203,6342904
9606,0,30,90,64.77123204,151.14746090000003,12.29420436,60,1009,1049,1027.9520300000001,94.11621094,40,128,152.99080849999999,140.40527340000003,50,268500,67627864,1497996
10628,0,-252,1202,327.8305107,102912.37400000001,320.79958539999996,1454,607,1480,1037.396124,24989.07715,873,-19,219.1985401,5237.803711,424,6878262,68876206,3075072
3135,0,-2909,5050,991.4250161,982192.8740000001,991.0564434,7959,-156,2715,1303.920561,377960.3787,2871,-1762,443.86271460000006,129989.7537,2405,62907108,108813365,12608903
1094,0,-40,30,13.46291202,142.1875,11.92424002,70,970,1009,981.4152885999999,79.078125,39,306,355.15909730000004,655.9919434,109,11600,61643262,8072831
1977,0,-2333,1131,789.8072649000001,510068.4919,714.1907952,3464,-352,2284,1273.626454,323877.7412,2636,-821,468.9836751,161985.125,2256,39922913,103815958,14076524
8891,0,-363,979,330.8261911,68566.18359,261.8514533,1342,735,1401,1015.279687,16680.90527,666,-158,340.3136651,12662.01733,702,7004542,65970742,7412057
1268,0,-3161,1111,734.5014785,425955.0134,652.6522914,4272,284,1450,996.9504203,52737.30835,1166,-891,403.1368215,44881.015380000004,1752,34527515,63610249,10401235
8531,0,-969,1414,493.42395880000004,183984.5662,428.93422130000005,2383,607,2117,1291.6704359999999,122081.406,1510,-1722,301.5163501,69142.02905,2118,15581901,106778401,5818375
8650,0,-898,4777,665.6241315000001,415742.7576,644.7811703,5675,245,2715,1111.3243439999999,95585.6228,2470,-712,232.94396459999996,23632.42163,1345,28355551,79042675,3472825
2846,0,-575,171,240.66080899999997,19758.444340000002,140.56473359999998,746,686,1323,972.6746950999999,16860.31152,637,-237,378.9384432,39406.6084,1068,3706728,60550148,9190038
10364,0,50,90,73.4102343,64.62402344,8.038906856,40,931,960,943.5557332999998,75.68725586,29,415,440.91878499999996,121.26464840000001,50,344900,56979035,12442200
2810,0,-404,353,203.1683415,14145.1084,118.9332098,757,745,1245,1008.46242,10391.83374,500,-653,369.3898474,64096.26538,1563,2641752,65087773,8732727
6475,0,40,80,62.11129124,87.08496094,9.331932326,40,990,1029,1012.4768050000001,79.58984375,39,207,231.4943304,127.51464840000001,50,246900,65606994,3429736
8395,0,90,131,112.8856584,76.37280273,8.739153434,41,990,1039,1017.598867,105.8103027,49,158,186.9408747,158.81225590000003,49,815563,66272477,2236601
2392,0,-1050,616,445.07557289999994,140334.658,374.61267730000003,1666,156,2029,1108.957097,165406.7461,1873,-1009,326.3253505,59730.92944,1761,12677905,78706294,6815247
9033,0,-242,2101,442.2330586,144345.658,379.92849060000003,2343,460,1656,987.1411294,37030.318119999996,1196,108,379.83162389999995,10841.6709,723,12516485,62364647,9233412
3248,0,-60,-20,37.62479236,78.80859375,8.877420445,40,911,950,936.1086257999999,57.10327148,39,435,467.4732613,121.06933590000001,50,90600,56083159,13986000
1791,0,-323,565,230.2615022,25292.90601,159.03743590000002,888,264,1901,1073.6602699999999,84042.70215,1637,188,349.0945431,24093.52734,861,3393303,73775768,7799488
5904,0,-1828,1414,546.6227704,258150.113,508.08474989999996,3242,352,2088,1123.288977,129615.62400000001,1736,-1069,407.5078028,72665.51929,2078,19122973,80753800,10628007
2478,0,-2282,1555,734.8882568,469454.2959,685.1673488,3837,254,2460,1187.273761,250934.9314,2206,-1613,484.60997530000003,125213.4099,2533,34563888,90215615,15030197
10705,0,-1383,969,379.7893536,108524.8591,329.4311144,2352,725,1343,1037.387931,6500.65625,618,-138,184.3655082,11850.13062,801,9231357,68875118,2175401
5340,0,-60,-20,40.50462937,90.234375,9.499177596000001,40,852,901,876.5578097000001,101.34375,49,544,569.3837678,81.15234375,40,105000,49174630,20748664
10804,1,-4919,2686,894.9895251,720704.8594,848.9433782,7605,-529,4627,1229.485436,475692.1523,5156,-2118,516.5453907,152860.1501,3662,51264400,96744604,17076425
10805,1,-2626,1080,660.0974123,353485.1084,594.5461365,3706,-568,2421,1113.071377,186732.7732,2989,-247,552.837934,96294.93652,1603,27886630,79291385,19560306
10806,1,-2333,2040,628.7589835,318946.0818,564.7531157999999,4373,98,3058,1009.6945619999999,159429.738,2960,-1257,502.71172469999993,130645.2693,2237,25301623,65246919,16174021
10807,1,-1858,1707,488.6011922,165594.6836,406.9332668,3565,235,2088,984.8902857999999,68043.1709,1853,-1445,542.9610368,145907.1719,2989,15278792,62080568,18867628
10808,1,-1676,696,470.0490831999999,148727.9763,385.65266280000003,2372,-264,1970,978.9824914999999,86459.2959,2234,-207,385.21582830000006,28837.366939999996,1038,14140553,61338030,9497039
10809,1,-1757,1050,513.2752216,188006.8142,433.5975256,2807,-19,2656,1043.406283,161538.3162,2675,-1831,509.7981831,155403.625,2801,16860893,69676587,16633228
10810,1,-1555,1373,539.012668,205124.5938,452.90682680000003,2928,-166,2490,1034.62944,173619.4841,2656,-1742,513.4532293999999,175721.9688,2821,18594218,68509317,16872590
10811,1,-878,60,331.08300039999995,35317.1189,187.9284941,938,411,1480,964.9692028999999,23849.78027,1069,29,342.61936789999993,8426.147461,525,7015421,59594596,7512834
10812,1,-404,-30,210.27062180000004,6413.868896,80.08663369,374,862,1068,973.2497592,1762.725586,206,217,332.92890570000003,2765.09375,287,2829679,60621766,7093866
10813,1,-282,20,190.7353369,3664.203125,60.53266164,302,931,1107,975.6859206,1124.7224119999998,176,237,323.0127706,1075.444336,178,2328318,60925633,6677584
10814,1,-353,-50,202.15877890000002,4094.116943,63.98528693,303,921,1039,979.1735674,645.7880859,118,277,319.4518988,597.3122559,128,2615563,61361976,6531169
10815,1,-484,171,211.92543650000002,13941.89038,118.07578240000001,655,715,1166,980.5912837000001,6877.603270999999,451,247,330.9208034,1524.4567869999998,188,2874393,61539793,7008549
10816,1,-343,101,203.07114669999999,8289.968506000001,91.04926417,444,892,1058,964.5593311000001,1410.048584,166,267,352.2991893,1549.084961,198,2639225,59543981,7943342
10817,1,-2494,2070,539.2370622999999,275636.0759,525.0105484000001,4564,-235,1990,1069.127894,168896.2966,2225,-475,394.5792062,39731.217769999996,1306,18609703,73154205,9964336
10818,1,-4989,1626,1140.2597289999999,1197572.132,1094.336389,6615,-500,2147,1217.937357,406640.9131,2647,-2841,667.0095811000001,321569.1211,4959,83212304,94935770,28473714
10819,1,-4919,1111,1097.912992,1126890.39,1061.5509359999999,6030,9,3098,1075.445024,366149.8711,3089,-2633,555.7506045,211699.8962,4603,77146428,74021248,19766959
10820,1,-4989,1393,1015.756668,904546.7829999999,951.0766441,6382,-1049,2205,1188.346895,621347.2021,3254,-1257,721.0447823,397591.4451,4118,66032743,90378774,33273957
10821,1,-727,111,360.6407925,34561.467769999996,185.9071483,838,303,1480,993.4993552000001,48685.49609,1177,59,366.1327457,16982.288090000002,525,8323954,63170622,8579404
10822,1,-2444,1808,749.1623552,430911.9529,656.4388417,4252,-745,2362,1018.4790130000001,299740.5898,3107,-2554,732.3331828,390232.6619,3920,35919631,66387168,34323961
10823,1,-1434,848,477.4846365,130676.8259,361.4924977,2282,362,2401,1004.9436400000001,77178.2959,2039,-1821,552.306018,230342.2148,3316,14591461,64634350,19522684
10824,1,-595,60,313.1706055,16270.89038,127.5574003,655,588,1235,955.7334143999999,10540.38062,647,19,333.63286800000003,11898.77124,674,6276853,58459287,7123897
10825,1,-353,-111,250.55373050000003,2099.626709,45.82168383,242,882,1098,968.4248487,2576.366211,216,217,325.83826989999994,3059.347412,327,4017739,60022188,6794917
10826,1,-363,-70,249.32787779999998,3305.081787,57.48984073,293,833,1166,963.4507722999999,6367.37085,333,217,331.4775633,1924.058594,188,3978521,59407193,7032152
10827,1,-767,30,299.9106117,19804.163090000002,140.7272649,797,686,1627,973.7157407,15932.09375,941,-930,379.4400891,43782.749019999996,1702,5756568,60679830,9214386
10828,1,-979,565,392.49749199999997,67783.57715,260.3527936,1544,411,1519,991.8290002,54338.38842999999,1108,-495,367.9023733,51252.15625,1653,9859474,62958385,8662538
10829,1,-1121,808,420.2329153,94289.47241,307.06590889999995,1929,411,2509,976.1435441,65433.34277,2098,-712,392.3948705,39698.04468,1454,11302125,60982798,9854319
10830,1,-1494,1010,411.4272225,91230.69897,302.04420039999997,2504,431,3068,1013.5938070000001,135646.3086,2637,-613,483.0984954,112388.8818,2692,10833431,65751834,14936586
10831,1,-707,363,368.03886939999995,53146.37866,230.5349836,1070,431,2009,960.2022572999999,56972.12109,1578,-376,457.77525870000005,60103.45996,1356,8668967,59007256,13411724
10832,1,-545,-50,255.7874789,8179.195068000001,90.43890241,495,764,1176,954.6264322000001,6435.0625,412,138,355.0344834,5759.736084,426,4187343,58323944,8067167
10833,1,-939,909,376.54888460000006,87849.0,296.39331980000003,1848,-88,2823,1041.6646380000002,129925.4961,2911,-851,404.3577662,58133.95679,1851,9074500,69444174,10464333
10834,1,-2717,838,560.8923136,248326.1211,498.3233098,3555,176,2500,1040.5414759999999,179870.2773,2324,-1544,524.6110464,156708.6875,2791,20134412,69294500,17613872
10835,1,-1464,1292,505.1935427,130026.1736,360.591422,2756,-29,1598,948.0567625,74801.5625,1627,-277,436.3011073,49944.51465,1128,16334113,57523944,12182954
10836,1,-3737,1202,635.9395853999999,331333.4131,575.6156818,4939,-58,1960,971.1681914999999,117511.4756,2018,-544,472.57654800000006,91990.30371000001,1969,25882826,60362730,14293030
10837,1,-969,232,311.9373435,37539.936519999996,193.7522555,1201,470,1205,967.5086805,21509.56421,735,-475,401.9464361,24174.881840000002,1158,6227514,59908675,10339900
10838,1,-555,-40,277.8842778,8485.579834,92.11720705,515,745,1196,951.8331162999999,7815.452148,451,158,354.13984700000003,6282.194336,317,4942059,57983122,8026562
10839,1,-535,191,290.13415539999994,20129.29077,141.87773180000002,726,696,1205,956.6879961000001,12365.94312,509,168,353.41370939999996,5984.038086,307,5387381,58576123,7993680
10840,1,-1545,575,375.5659895,84063.1709,289.93649460000006,2120,509,1852,974.1099222000001,46360.452880000004,1343,-514,398.7205514,42601.1521,1514,9027188,60728969,10174597
10841,1,-4989,1151,957.9425136,861195.6443,928.0062738,6140,-1000,2754,1172.654041,409012.8037,3754,-2495,671.5956396,353140.1599,4237,58729847,88007520,28866605
10842,1,-4676,3282,1201.859022,1369910.513,1170.4317640000002,7958,-1019,3617,1236.851819,563298.3787,4636,-1336,599.6281921,268727.0781,2900,92445767,97907355,23011454
10843,1,-3020,727,641.3284917999999,269514.6853,519.1480379,3747,68,1784,945.9339961000001,103247.2773,1716,-950,394.16089669999997,55566.05371,1900,26323343,57266632,9943220
10844,1,-989,-10,390.4079997,39627.381839999995,199.066275,979,117,1686,956.7045978,64853.90234,1569,39,373.79688250000004,18674.47827,594,9754778,58578156,8942343
10845,1,-737,171,373.4130588,36195.58984,190.25138590000003,908,352,1450,945.9029912000001,31284.9834,1098,-148,373.2268914,22697.40527,890,8923988,57262878,8915092
10846,1,-909,676,409.79541389999997,60737.42871,246.4496474,1585,235,1676,1006.574699,94889.6709,1441,-1138,459.9713136,121057.2458,2652,10747666,64844328,13540711
10847,1,-3656,1404,716.0147301,444702.8271,666.8604255,5060,-696,4098,1157.521335,494519.0564,4794,-1683,585.897522,250517.5898,2702,32811334,85750761,21969658
10848,1,-898,80,354.78061,46362.905269999996,215.32047110000002,978,186,1794,980.6578388,68694.32788,1608,59,369.67751989999994,24687.57813,673,8055634,61548147,8746334
10849,1,-1505,919,425.84230870000005,100552.4919,317.10012919999997,2424,294,2294,979.4007016,96329.88452,2000,-663,473.60127939999995,113002.9568,2088,11605867,61390447,14355083
10850,1,-1010,121,343.6841755,36875.999019999996,192.0312449,1131,490,1607,979.6049188,28732.486080000002,1117,-99,342.9494086,19537.673580000002,693,7559604,61416051,7527315
10851,1,-2414,848,427.34640880000006,128750.1912,358.8177687,3262,-421,2578,1019.9590910000001,109302.6287,2999,-554,372.8923898,30571.136469999998,1316,11687997,66580259,8899119
10852,1,-1040,313,325.2820411,35483.99609,188.3719621,1353,696,1205,956.2570506000001,8450.767334,509,99,346.70865380000004,8347.997803,405,6771738,58523363,7693241
10853,1,-1707,2747,615.9995687999999,302691.8398,550.1743722,4454,29,4235,1074.296529,267749.624,4206,-1168,499.4178955,123670.4255,2692,24285150,73863234,15962767
10854,1,-1646,1161,451.5407304,152146.999,390.0602505,2807,0,3352,1036.8144869999999,157519.6318,3352,-1405,491.3620737,97606.125,2771,13048898,68798994,15451948
10855,1,-909,464,300.6430608,44067.13965,209.92174649999998,1373,647,1225,965.7321866000001,8096.311523,578,148,345.5432996,5588.823975,317,5784720,59688874,7641611
10856,1,-383,-60,198.89825449999998,6294.175537,79.33584018,323,872,1058,966.1126196,1062.6523439999999,186,287,352.5433262,1491.3063960000002,158,2531873,59735910,7954355
10857,1,-1595,444,305.78584720000003,59975.94116,244.89985950000002,2039,-186,1470,949.6826361,74223.61693999999,1656,39,438.1729467,42709.89063,1683,5984319,57721415,12287714
10858,1,-5000,2777,1314.732167,1615551.16,1271.043335,7777,-1137,1843,1052.667668,375052.1836,2980,-435,780.0781311000001,383771.82200000004,4187,110625323,70918990,38945401
10859,1,-5000,1313,1048.251684,954455.3428,976.9623037,6313,-1000,2990,1099.559251,454168.2361,3990,-1089,659.656871,316875.6787,3584,70325222,77377955,27849420
10860,1,-4777,1151,1002.5764539999999,915823.9412,956.9869074999999,5928,-1352,3539,1134.622783,572102.2263,4891,-792,484.73733219999997,121464.46,2356,64330211,82391607,15038098
10861,1,-4989,2686,1319.98695,1704273.486,1305.4782599999999,7675,-1078,3941,1384.590694,1035927.834,5019,-1198,514.5311124,176728.0642,2574,111511395,122693849,16943505
10862,1,-4989,2484,1222.216257,1408009.3530000001,1186.595699,7473,-1166,2745,1250.189048,705728.1406,3911,-1079,593.5909524,223289.6563,2564,95604005,100030250,22550414
10863,1,-4989,1313,1012.348793,878316.6306,937.1854836000001,6302,-196,3882,1169.311162,361906.3711,4078,-653,450.9537636,110229.4236,2286,65590405,87506470,13014995
10864,1,-4424,1484,872.7991249,659877.7021,812.3285678999999,5908,-598,2931,1083.870906,355666.2947,3529,-2178,659.746862,342954.3923,4762,48753812,75185673,27857019
10865,1,-1404,757,540.8307990000001,180388.0798,424.7211789,2161,-490,4186,1232.494048,504772.2849,4676,-495,395.69097,63832.06152,1485,18719869,97218661,10020566
10866,1,-4989,1606,1275.2494060000001,1433800.615,1197.414137,6595,-509,4588,1214.871617,567852.947,5097,-1415,516.5455116999999,156958.0916,3147,104080707,94458435,17076433
10867,1,-989,2777,563.9507265,199973.0193,447.1834291,3766,-1676,2137,1000.7459560000001,177936.2188,3813,-69,340.7685477,22037.226319999998,910,20354587,64095518,7431885
10868,1,-777,-232,392.5426131,10839.281009999999,104.1118677,545,607,1245,940.3176657,12891.74609,638,178,287.9179571,2027.609375,247,9861741,56588628,5305392
10869,1,-494,-202,379.1279055,2643.828125,51.41816921,292,852,1088,939.8799541000001,2093.429443,236,148,271.11209049999997,1518.55249,208,9199230,56535957,4704113
10870,1,-494,-202,381.4105605,2601.8278809999997,51.00811583,292,823,1254,938.3302407,5215.685303,431,158,262.9610534,1507.8845210000002,238,9310337,56349673,4425505
10871,1,-454,-202,355.31484720000003,2069.488037,45.49162601,252,892,1049,945.386619,1528.0251460000002,157,188,272.7769522,1177.8317869999998,148,8079913,57200375,4762065
10872,1,-1848,595,477.3975675,100102.1875,316.3892974,2443,421,1480,961.4607945,31411.39038,1059,-712,306.20027660000005,24466.27319,1335,14586140,59162039,6000551
10873,1,-3131,2171,727.6700832,473601.0586,688.1867905,5302,-2156,4764,1259.391092,757141.0291,6920,-4950,840.3139666000001,619028.7969,7078,33888240,101508219,45192164
10874,1,-3656,909,696.7553597,386930.8975,622.0376977999999,4565,98,2392,1061.267057,145537.9705,2294,-772,419.5167421,54966.40991,1880,31069954,72082417,11263635
10875,1,-4737,1131,1143.9164289999999,1157138.6909999999,1075.703812,5868,117,2852,1025.657647,239862.8611,2735,-1198,579.4350832,199803.0212,3435,83746867,67326311,21487681
10876,1,-5020,4010,1478.891725,2126934.845,1458.401469,9030,-2823,4254,1467.6841769999999,1189834.2179999999,7077,-524,744.2703432,386401.6211,5147,139975727,137862198,35452054
10877,1,-2444,929,492.3500882,175448.9607,418.86628019999995,3373,303,2235,1033.762402,67195.41382,1932,-772,335.06969889999993,84917.64429,1742,15514151,68394541,7185389
10878,1,-646,161,237.4784201,20604.08984,143.5412479,807,784,1176,1016.956857,4864.183594,392,-287,164.5988969,15533.187259999999,623,3609344,66188880,1733939
10879,1,-1656,535,379.46576339999996,124354.8708,352.63986,2191,333,1882,1048.824841,53216.80835,1549,-742,231.0966383,42544.1084,1435,9215633,70402147,3417962
10880,1,-1797,3282,618.9405515,339144.7656,582.3613703,5079,245,3745,1113.559341,201271.2461,3500,-1118,360.310413,109774.8037,1969,24517594,79360922,8308710
10881,1,-1828,585,393.1192567,91808.15527,302.9986061,2413,441,1607,1027.59719,36203.14233,1166,-445,245.7701543,46508.45313,1138,9890736,67581183,3865790
10882,1,-606,191,278.0218348,21872.6814,147.8941561,797,774,1137,1004.5874,4816.058594,363,-99,184.1151134,10297.73438,544,4946953,64588534,2169496
10883,1,-929,222,325.0340848,44854.08984,211.78784159999998,1151,823,1235,1003.350216,7024.131836,412,-455,229.98807709999997,23744.288819999998,930,6761418,64429546,3385249
10884,1,-1818,222,377.779677,80490.6228,283.7086936,2040,245,1705,1017.835625,39642.26733,1460,-485,243.4182037,38086.71851,1039,9133919,66303319,3792155
10885,1,-808,262,317.2963668,48942.0603,221.2285251,1070,784,1215,1007.7033759999999,9707.828125,431,-594,220.4425946,26690.9375,1098,6443327,64989830,3110076
10886,1,-1656,969,463.8536609,180912.0898,425.3376187,2625,117,2303,1066.0937900000001,112728.1943,2186,-1574,382.120911,123464.7986,2296,13770254,72739582,9345049
10887,1,-1242,969,409.5172654,136037.0759,368.832043,2211,421,1480,1015.128956,23192.292719999998,1059,-267,315.9091048,51604.592769999996,1009,10733081,65951155,6387108
10888,1,-5000,2969,1055.940776,1022243.088,1011.0603779999999,7969,-1735,4598,1194.4071880000001,472323.7656,6333,-1346,478.44923650000004,174238.0798,2751,71360699,91302946,14650475
10889,1,-5010,2848,923.6589349999999,738531.8416,859.3787533,7858,-470,3598,1147.1063800000002,401827.4197,4068,-1970,506.08960419999994,225698.2461,2950,54601333,84214595,16392108
10890,1,-646,-101,319.0361461,13537.93359,116.3526261,545,833,1088,983.463586,3490.2773439999996,255,-79,186.8288405,9559.380615,534,6514180,61900840,2233921
10891,1,-717,222,305.8423562,27707.21265,166.4548367,939,754,1264,1007.553317,9154.6875,510,-217,185.6992697,10517.30859,622,5986531,64970476,2206990
10892,1,-838,181,333.8328783,44387.66968,210.6838145,1019,656,1352,1010.1484109999999,20274.80859,696,-524,222.74544049999997,27988.152339999997,1108,7132441,65305588,3175394
10893,1,-3242,828,554.0149478999999,208140.2148,456.2238648,4070,107,2117,1016.898417,91635.81812000001,2010,-712,268.45905760000005,43998.3103,1355,19643684,66181273,4612497
10894,1,-1070,80,365.6234402,43811.70215,209.312451,1150,382,1470,987.592108,30523.79663,1088,-128,208.4593036,17845.28027,702,8555552,62421643,2781138
10895,1,-989,151,373.4250469,50521.161869999996,224.76913009999998,1140,656,1156,972.5858332999999,12797.390379999999,500,-79,190.5149272,11312.18359,484,8924561,60539085,2322940
10896,1,-949,161,365.75941969999997,44182.626710000004,210.19663819999997,1110,107,1647,987.8094451999999,61771.74902,1540,-237,342.87782539999995,66114.20483,1217,8561917,62449120,7524173
10897,1,-2373,1565,674.6925573,375094.5134,612.4496007,3938,-754,2960,1141.119516,316352.9844,3714,-1663,542.1826549,267819.1836,3732,29133443,83337840,18813570
10898,1,-1656,1373,527.8204298999999,193257.3906,439.6104988,3029,333,1686,1000.30575,42721.20215,1353,-2435,454.8877265,176950.5781,3415,17830042,64039142,13243062
10899,1,-4979,1555,949.5535053,848052.3748,920.8975919,6534,-529,2274,1125.257852,193977.3435,2803,-702,448.5500773,152432.1111,2018,57705719,81037135,12876619
10900,1,-2989,1373,690.0478017999999,416553.6943,645.4097103999999,4362,245,1431,994.9773945000001,36702.38647,1186,-267,368.5595695,63693.55371,1356,30474622,63358721,8693514
10901,1,-262,-50,153.6471201,1126.1835939999999,33.558659000000006,212,931,1049,1006.463316,303.5585938,118,128,229.2399466,801.8122559,149,1510876,64829978,3363261
10902,1,-2383,1212,579.0995435,300492.3896,548.1718614,3595,215,1735,1037.808102,81790.01563,1520,-1653,487.3581685,168537.8865,2880,21462802,68930922,15201151
10903,1,-828,696,298.6039392,72231.79688,268.75973819999996,1524,735,1862,1064.74887,34665.538089999995,1127,-346,277.7685637,20927.10938,969,5706516,72556170,4937944
10904,1,-4222,3171,1310.989655,1667674.3590000002,1291.384667,7393,-529,2294,1163.8863310000002,384929.6013,2823,-930,542.0026666,223201.949,2514,109996408,86696409,18801081
10905,1,-1676,2333,652.2582526000001,407363.1853,638.2500962,4009,450,2137,1029.13748,63213.51342999999,1687,-584,484.94671100000005,87741.31152,1683,27228213,67783933,15051092
10906,1,-1252,2272,513.4179432,242541.2537,492.48477510000004,3524,313,4058,1096.811772,199868.6211,3745,-4346,768.5237268999999,508957.7959,6167,16870271,76991748,37800238
10907,1,-4939,1696,1231.046982,1496081.7580000001,1223.14421,6635,-813,2558,1217.396376,406684.9375,3371,-722,458.0871744,161615.5818,1890,96990507,94851452,13430007
10908,1,-4959,1464,1365.3798689999999,1776683.1840000001,1332.9227970000002,6423,-568,3774,1207.310758,437152.0486,4342,-980,530.5469906999999,229517.4822,2930,119312780,93286353,18014727
10909,1,-5000,3080,1496.497024,2113766.616,1453.879849,8080,-627,2627,1148.54952,349556.5273,3254,-2306,610.9796052999999,324999.1482,4008,143328214,84426624,23890949
10910,1,-4878,1424,999.3873436000001,971714.8125,985.7559599,6302,19,3362,1160.944389,286376.8125,3343,-1247,529.6519346,270936.3572,3514,63921604,86258680,17953995
10911,1,-3666,1636,1103.515469,1071667.162,1035.213583,5302,-549,2950,1128.898481,293631.0381,3499,-3475,733.1340579,491468.5935,5098,77935769,81562354,34399075
10912,1,-1959,3525,932.3119113,837074.9375,914.9179949999999,5484,196,3372,1080.047966,239585.9607,3176,-1970,616.6873195000001,237206.5459,3504,55629152,74656231,24339408
10913,1,-1464,2646,834.7527609,673139.4646,820.4507692000001,4110,78,3578,1192.897798,362362.6406,3500,-1346,443.13284550000003,106554.1211,2969,44595979,91072330,12567470
10914,1,-1686,1939,705.8661125,452611.3281,672.7639468,3625,186,2156,1056.119962,120320.7803,1970,-1237,600.7582057999999,241615.738,3514,31887806,71384920,23098267
10915,1,-1929,1909,701.8685107000001,492124.3438,701.5157472999999,3838,303,3205,1096.7326970000001,192326.4607,2902,-2257,615.5139875,282893.0459,4257,31527642,76980647,24246878
10916,1,-4515,1949,1178.625616,1327126.215,1152.009642,6464,-29,2245,1146.92316,169830.4392,2274,-524,436.40122740000004,95119.46875,2068,88906134,84187695,12188546
10917,1,-5000,4090,1294.1315439999998,1599691.89,1264.7892669999999,9090,29,1901,1083.210491,195965.5781,1872,-683,542.3420997000001,225875.2263,2801,107185693,75094078,18824637
10918,1,-4979,3565,1145.295909,1300841.1709999999,1140.544243,8544,-303,3372,1156.858806,315600.9275,3675,-2306,563.2893073,299380.6943,3216,83948974,85652627,20306870
10919,1,-5000,4292,1612.745771,2518157.851,1586.870458,9292,-529,2637,1215.086918,355484.6563,3166,-1831,837.8130851,586405.1287,5890,166460731,94491918,44923569
10920,1,-5000,3393,1488.804701,2172044.809,1473.785876,8393,-29,2607,1174.1391529999999,324194.6631,2636,-1465,700.2372588999999,452441.1631,5653,141858524,88230576,31381262
10921,1,-5010,4828,1365.763946,1864548.0159999998,1365.484535,9838,-1617,3098,1258.34217,448900.4646,4715,-1227,506.4817834,215244.9861,3880,119379914,101339201,16417523
10922,1,-5010,4676,1287.178843,1605993.218,1267.277877,9686,-1029,2990,1136.780384,337343.6931,4019,-1356,496.193243,177588.2947,2910,106037080,82705257,15757295
10923,1,-5000,2727,1495.641726,2046889.045,1430.695301,7727,-480,3617,1248.5544949999999,330704.8982,4097,-1019,421.79978960000005,123451.1719,1860,143164427,99768853,11386564
10924,1,-4636,2292,906.7216530999999,740455.3711,860.4971651000001,6928,-686,2813,1163.60567,339488.5459,3499,-1237,722.4255801,482359.8818,6038,52617226,86654602,33401518
10925,1,-4878,1808,1455.432533,2054219.504,1433.2548630000001,6686,-441,2990,1256.082607,494810.6052,3431,-3415,792.4751672,626823.4041,4751,135570167,100975585,40193081
10926,1,-5010,4858,1462.885905,2139248.545,1462.617019,9868,-1000,3294,1240.708832,483152.5771,4294,-2158,867.9664092,685863.1523,6900,136962251,98518938,48215404
10927,1,-5000,2242,1262.891245,1517462.539,1231.853294,7242,-470,2921,1142.4836300000002,321142.8428,3391,-1306,792.5348573,595745.2412,5939,102073235,83537206,40199136
10928,1,-4989,1232,1251.0105230000001,1496112.875,1223.15693,6221,-147,2627,1160.280839,314440.0771,2774,-1099,552.1840867000001,292610.5349,3930,100161749,86160104,19514065
10929,1,-5000,1434,1049.775735,1077663.835,1038.105888,6434,-460,1833,1152.021511,303958.0928,2293,-821,380.2624299,128410.9294,2028,70529862,84937828,9254369
10930,1,-5000,2484,1502.379384,2119943.022,1456.0024119999998,7484,-774,4676,1334.060853,740879.6482,5450,-2128,1171.705408,1292503.5929999999,6593,144457204,113901975,87865188
10931,1,-4989,3252,1205.7857199999999,1398230.5780000002,1182.468003,8241,-431,2872,1205.688593,471139.3982,3303,-1009,471.3963466,213055.4275,3088,93050829,93035839,14221729
10932,1,-5000,1868,1356.66098,1688660.49,1299.484702,6868,-254,2676,1165.035333,340077.4939,2930,-920,433.59728939999997,168524.5564,1890,117793857,86867669,12032423
10933,1,-4939,1868,1300.479419,1630930.429,1277.078866,6807,-480,3686,1269.3773019999999,644200.1501,4166,-1485,694.9719082,468029.4275,4405,108239790,103124399,30911101
10934,1,-5000,2121,1112.565405,1132643.452,1064.2572300000002,7121,-892,3254,1212.587606,512141.8474,4146,-1950,577.4443155,317431.7803,4227,79219314,94103597,21340284
10935,1,-4989,2949,1211.245504,1403209.4119999998,1184.5714039999998,7938,-754,3529,1304.764873,606987.4844,4283,-1524,598.6232251,273058.3884,3009,93895403,108954328,22934385
10936,1,-4595,1363,1116.0575279999998,1208190.5159999998,1099.177199,5958,-19,2000,1047.981274,196536.46,2019,-1099,532.8712174,232429.8279,2356,79717402,70288944,18172911
10937,1,-5000,4363,1182.648749,1396621.7969999998,1181.787543,9363,-470,4000,1223.153832,449480.3884,4470,-4009,806.7108178999999,629739.2148,6474,89514116,95750739,41650070
10938,1,-4939,2020,1479.482764,1991955.188,1411.366426,6959,-1137,4705,1344.651378,834627.6052,5842,-1792,993.2450683000001,923181.3025,5554,140087632,115717589,63138289
10939,1,-4646,1272,1240.673595,1423394.554,1193.061002,5918,-509,3911,1240.312612,578526.5459,4420,-1089,670.4721983,421035.3086,3197,98513342,98456024,28770110
10940,1,-4363,1555,1223.538503,1404478.406,1185.106918,5918,-441,4450,1312.008658,733206.4648,4891,-1504,677.9136537,429328.9724,3424,95810974,110167470,29412283
10941,1,-5000,2737,1431.6095779999998,1966408.914,1402.2870300000002,7737,-1519,3950,1376.5876859999998,994985.6836,5469,-1891,915.5268633,811108.6211,6633,131168383,121279594,53644124
10942,1,-4656,1848,1137.283805,1155344.15,1074.8693640000001,6504,-686,4313,1273.8364789999998,681638.1211,4999,-1019,480.9766268999999,206517.4978,2306,82778525,103850200,14805665
10943,1,-4989,2090,1529.999724,2122430.554,1456.856394,7079,-960,2882,1279.739567,655745.2634,3842,-851,518.9355692,253731.5625,2761,149817546,104814935,17234824
10944,1,-4969,1828,1355.598611,1668829.3280000002,1291.831772,6797,-715,4490,1365.483311,783627.0642,5205,-1386,546.4903218,293150.2048,2960,117609446,119330859,19113707
10945,1,-4989,1121,1126.382609,1168486.3909999998,1080.96549,6110,-1225,2941,1383.6967300000001,846978.7888,4166,-1207,674.950357,438799.8728,3523,81199218,122535465,29155711
10946,1,-4989,2010,1235.901695,1326328.78,1151.663484,6999,-1352,4656,1485.2529880000002,1397719.249,6008,-2930,856.0680829,730305.4678,4979,97756992,141182492,46902564
10947,1,-5000,1020,1143.298435,1135864.663,1065.769517,6020,-1098,2539,1404.979988,955414.7419,3637,-1089,759.9730258,531990.0928,3593,83656404,126334001,36963776
10948,1,-5000,1373,1296.550574,1500325.41,1224.877712,6373,-1460,2617,1332.420407,963346.0349,4077,-970,522.8393037,261081.5273,3118,107586777,113622025,17495100
10949,1,-989,272,420.29942819999997,58884.673579999995,242.66164419999998,1261,235,1696,996.5501508,65050.917720000005,1461,-346,250.94256690000003,40905.9978,1029,11305703,63559181,4030219
10950,1,-4272,1323,1019.5843980000001,992463.3438,996.2245447999999,5595,-9,2225,1131.972394,187572.3506,2234,-801,502.6696853,159422.9219,2593,66531350,82007136,16171316
10951,1,-4989,2151,1253.960021,1492335.5780000002,1221.611877,7140,-539,2117,1022.9588289999999,201740.1658,2656,-1000,589.5874352000001,242110.1836,2603,100634607,66972465,22247254
10952,1,-1747,848,516.4767359,219210.5928,468.19930880000004,2595,352,2598,1098.00619,118094.5068,2246,-702,350.3690019,77362.80859,1702,17071886,77159526,7856540
10953,1,-3727,1222,1060.660466,1046127.413,1022.8037019999999,4949,-225,3500,1255.098129,357145.2148,3725,-1188,710.1024794,427291.3037,4059,72000040,100817364,32271714
10954,1,-4232,949,1075.262882,1094833.4270000001,1046.342882,5181,-500,3725,1209.899189,421765.9861,4225,-1099,592.6922684,299826.0381,2910,73996177,93686787,22482184
10955,1,-4202,1464,1015.494653,968799.6833,984.2762231,5666,-794,2519,1122.301388,334116.4063,3313,-891,493.3850392,192105.3103,2653,65998681,80611866,15579443
10956,1,-4959,1373,1119.541536,1213448.215,1101.5662550000002,6332,-1058,2852,1293.6168949999999,706018.7439,3910,-910,649.5877779,367602.4443,2781,80215888,107100459,27005714
10957,1,-5000,1616,1378.155119,1754721.469,1324.659001,6616,-813,2186,1200.812642,609180.6836,2999,-722,566.3652201,240927.9961,2890,121555938,92284864,20529252
10958,1,-4989,1414,1288.32402,1591657.781,1261.609203,6403,-637,2078,1223.546542,497284.8787,2715,-623,470.6968073,137663.7927,2028,106225842,95812233,14179551
10959,1,-4414,1141,1270.107439,1491000.812,1221.065441,5555,-862,2372,1185.9336970000002,437721.4294,3234,-663,520.9007973,186028.0095,1910,103243066,90012079,17365609
10960,1,-4989,1515,1181.355471,1255748.124,1120.6016789999999,6504,-1058,2431,1271.545412,834238.699,3489,-861,836.5550638999999,613259.7021,3266,89318448,103476975,44788760
10961,1,-5000,989,1192.7450019999999,1282752.953,1132.586841,5989,-1225,2313,1327.804814,934965.625,3538,-1316,971.4931887,843755.3025,4375,91049001,112836200,60403137
10962,1,-5000,1505,1185.535052,1297221.513,1138.956326,6505,-1666,3872,1598.996829,1564307.929,5538,-1574,1016.833973,985695.5955,4564,89951575,163634615,66172885
10963,1,-3848,777,681.1787807,416398.7461,645.2896606,4625,-186,2656,1203.452462,352186.9822,2842,-1000,366.06633619999997,76104.17188,1831,29696290,92691061,8576292
10964,1,-4797,1565,1146.9512300000001,1193215.777,1092.344166,6362,-1205,2470,1232.992245,537197.625,3675,-762,459.5212012,140262.3513,2603,84191816,97297272,13514223
10965,1,-4181,1121,752.0733944,509215.5623,713.5934152000001,5302,-490,2166,1145.156335,304245.3398,2656,-801,634.1726771000001,337857.2693,2672,36199321,83928514,25739199
10966,1,-3939,1101,899.5694717,741112.3904,860.8788477,5040,-627,2019,1119.447171,381272.9063,2646,-891,569.6833138999999,259729.0564,3039,51790415,80202366,20770501
10967,1,-3929,1050,965.1692857,802086.7148,895.5929403999999,4979,-1460,2362,1241.770189,520030.1658,3822,-1346,545.5815561000001,240291.4998,2771,59619312,98687565,19050191
10968,1,-4979,1686,1538.3879960000002,2209499.71,1486.438599,6665,-843,2078,1158.900267,487164.6521,2921,-1594,550.5971049,219988.0193,2881,151464808,85955189,19402059
10969,1,-4666,1505,1360.967435,1653803.8730000001,1286.003061,6171,-784,2441,1110.301296,308647.2461,3225,-475,453.9265325,136625.281,1960,118542871,78897214,13187155
10970,1,-4959,1707,1206.681516,1369257.976,1170.152971,6666,-1313,2705,1245.459604,623920.9961,4018,-811,563.0624827,237665.1013,3058,93189138,99274856,20290519
10971,1,-5000,2121,1375.8818019999999,1742300.539,1319.962325,7121,-1411,2313,1256.8982839999999,619668.9021,3724,-752,496.28990710000005,180150.2244,2286,121155247,101106771,15763435
10972,1,-4989,1292,1069.25423,1003860.713,1001.9284970000001,6281,-1500,2627,1299.473439,865301.8281,4127,-900,738.7669837000001,482963.7656,3652,73171495,108072398,34929706
10973,1,-5000,2363,1399.694833,1789066.71,1337.559984,7363,-3735,4156,1479.016174,1384504.835,7891,-1425,535.8144356,242053.6794,3118,125385320,139999286,18374215
10974,1,-4878,1626,1279.756019,1501337.5780000002,1225.290814,6504,-1205,1950,1250.3279009999999,610591.3533,3155,-445,445.31642539999996,129433.2773,2039,104817630,100052471,12691630
10975,1,-1373,1101,496.67970999999994,201660.5681,449.06632930000006,2474,-333,2313,1157.210351,276980.113,2646,-405,331.31633769999996,58347.86694,1256,15788207,85704691,7025313
10976,1,-2606,1050,788.8594417,576047.3398,758.9778257,3656,-254,1980,1062.735827,132717.1943,2234,-346,452.9699907,118212.1162,2147,39827150,72282076,13131636
10977,1,-1818,979,551.8477059999999,267881.5916,517.5727887,2797,156,2245,1116.455258,113245.5615,2089,-574,397.406121,80855.98438,1910,19490297,79774230,10107624
10978,1,-2404,1161,665.5839307,391728.0273,625.8817998,3565,450,1980,1026.180707,72761.20996000001,1530,-128,336.92794110000006,37809.475589999995,939,28352126,67394998,7265308
10979,1,-3232,797,702.4785361,446101.8506,667.9085645,4029,480,1901,1053.040642,56475.078129999994,1421,-267,382.25895180000003,55068.84375,1781,31582470,70969254,9351802
10980,1,-888,515,348.5982421,64884.17163,254.7237163,1403,637,1519,992.4951038999999,31311.178710000004,882,-1613,507.2839904,172792.3982,3167,7777327,63042978,16469571
10981,1,-616,606,233.0888377,35808.89746,189.23239009999998,1222,754,1617,1018.4979519999999,22628.12671,863,-1188,496.1848037,192657.738,2881,3477146,66389637,15756759
10982,1,-2424,646,420.4541629,139863.6833,373.9835335,3070,676,1843,1014.806624,36166.17358,1167,-1673,498.37493729999994,191458.0564,3316,11314029,65909279,15896165
10983,1,-1030,464,278.58487260000004,56366.46875,237.4162352,1494,607,2088,1052.477954,48354.28125,1481,-465,388.461569,102164.9294,1732,4967010,70893430,9657753
10984,1,-525,414,241.4668714,30843.5459,175.62330680000002,939,549,1480,1033.426287,35936.12866,931,-712,383.60634530000004,78975.72241,1533,3731600,68350073,9417845
10985,1,-545,181,221.6436117,22122.15796,148.7351941,726,715,1294,996.6936198999999,13143.47827,579,-326,359.94485249999997,61691.90601,1434,3144057,63577483,8291859
10986,1,-828,232,251.04699509999998,23771.07813,154.17872140000003,1060,803,1980,1009.903538,20530.05859,1177,-544,356.03945530000004,52422.663089999995,1712,4033574,65273930,8112902
10987,1,-535,333,233.97679509999998,30443.253660000002,174.479952,868,774,1323,990.4440055,11769.843509999999,549,-663,443.0183405,92581.25,1861,3503689,62782677,12560976
10988,1,-919,1454,417.18163389999995,169829.7224,412.10401889999997,2373,813,1421,1022.864383,11676.49585,608,-326,318.5488581,40340.8125,1147,11138593,66960099,6494296
10989,1,-1494,3111,537.3396853999999,275154.4053,524.5516231,4605,441,1813,1029.689926,37761.18359,1372,-108,344.1215038,25022.51929,810,18478972,67856726,7578855
10990,1,-3303,1121,739.2290853,503357.98799999995,709.4772638999999,4424,98,1705,1034.270924,53022.24609,1607,-306,326.9644715,53089.015380000004,1395,34973417,68461846,6841969
10991,1,-3767,898,856.0913995,698441.6443,835.728212,4665,-186,2049,1065.3458210000001,103594.5273,2235,-247,342.14377,63578.57007,1850,46905119,72637550,7491991
10992,1,-4414,1242,1083.2347539999998,1111878.03,1054.4562720000001,5656,-411,2980,1133.311064,247560.9063,3391,-594,429.38899180000004,115107.2461,2366,75097442,82201214,11799994
10993,1,-3585,1010,1003.366085,899138.9990000001,948.2294021,4595,166,2137,1041.657521,103805.3689,1971,-247,404.61113660000007,85021.15601,1544,64431584,69443225,10477451
10994,1,-3626,1141,955.2896648,838560.3398,915.7294032,4767,-156,1588,1030.7025820000001,90829.56934,1744,-396,378.46334039999994,74081.93652,1613,58405014,67990260,9167008
10995,1,-2272,565,466.07327410000005,152668.6033,390.7282985,2837,401,1872,1019.2869519999999,35661.94897,1471,-188,296.40739489999993,22193.28125,900,13902355,66492537,5622870
10996,1,-1545,242,360.97812000000005,80122.20288,283.0586563,1787,382,1460,1023.1516949999999,32381.25562,1078,-653,369.9380016,89520.68359,1860,8339533,66997721,8758664
10997,1,-3737,848,770.1400441000001,514505.5469,717.2904202000001,4585,98,1931,1020.322919,70864.64038,1833,-227,352.1799744,38611.53882,1147,37959404,66627767,7937967
10998,1,-2616,1000,520.3188025000001,253191.9648,503.18184069999995,3616,450,1803,1047.255401,76138.8125,1353,-485,327.87843119999997,33885.314210000004,1306,17326826,70191608,6880273
10999,1,-3171,1070,776.8526545,503199.1775,709.3653343,4241,127,2352,1165.448881,220382.2021,2225,19,467.5921534,46144.970460000004,1129,38624003,86929350,13993115
11000,1,-898,414,224.1965864,31430.835689999996,177.2874381,1312,686,1362,1017.6751230000001,11645.15234,676,-663,301.14279730000004,49217.48022,1474,3216903,66282410,5803967
11001,1,-3060,1050,697.1134232999999,432244.5771,657.4530988,4110,470,1460,1019.514989,41472.249019999996,990,-930,365.68674689999995,89816.90405,1890,31101896,66522292,8558515
11002,1,-4111,1404,797.2137123,599062.7341,773.9914302999999,5515,-254,2519,1130.935675,242436.9844,2773,-465,370.2721761,86694.21851,1395,40675181,81856992,8774495
11003,1,-4070,1080,1010.3186919999999,946291.6208,972.775216,5150,-235,2284,1060.7497720000001,168247.5857,2519,-504,434.44472460000003,105311.5068,2197,65327607,72012165,12079502
11004,1,-3040,787,796.5441372,551610.5469,742.7048855,3827,117,1745,1020.1752449999999,79070.85059,1628,-247,371.406133,53197.84741,1662,40606884,66608482,8828321
11005,1,-2171,767,512.6129601,209663.4041,457.8901659,2938,303,1833,1014.937883,62334.84375,1530,-267,297.7552476,36816.58984,1158,16817411,65926330,5674124
11006,1,-3111,848,760.7076063999999,494104.1523,702.9254245,3959,284,2058,1026.206082,88805.60913,1774,-356,403.9180958,76704.64038,1930,37035268,67398331,10441589
11007,1,-1606,535,426.38313539999996,143954.0916,379.4128247,2141,529,1509,1033.051918,35479.94507,980,-653,325.2891742,47105.271239999995,1464,11635365,68300561,6772035
11008,1,-1282,828,394.29898239999994,117847.8115,343.2896904,2110,176,2107,1024.673317,89432.90234,1931,-653,468.6924631,169832.0625,2603,9950188,67197146,14059048
11009,1,-3585,888,579.5361831,320970.5615,566.5426388,4473,186,2205,1065.746042,137626.3037,2019,-980,519.020276,229275.7263,3267,21495180,72692136,17240451
11010,1,-1767,272,434.09971490000004,132199.4756,363.59245810000004,2039,294,1705,1015.899348,32645.14624,1411,-356,330.4281787,34312.14063,1365,12060324,66051295,6987698
11011,1,-2232,363,535.6553813,223469.9287,472.726061,2595,529,1392,998.4895702,15117.19116,863,-128,281.67096269999996,23657.28027,712,18363308,63806811,5077666
11012,1,-2464,606,458.27758370000004,162125.7568,402.64842830000003,3070,421,1235,1002.413166,11508.47559,814,-19,277.8854868,9620.34375,514,13441174,64309258,4942102
11013,1,-3757,1171,772.1472496,507183.7344,712.1683329,4928,107,1352,993.3234382999999,49455.69116,1245,-306,351.38660600000003,47356.90991,1246,38157528,63148253,7902243
11014,1,-3686,666,667.8268395,385430.5537,620.8305353999999,4352,-549,1794,1030.4125609999999,111642.9451,2343,-584,437.54644400000006,123578.4998,2178,28543532,67952003,12252601
11015,1,-1323,171,267.6009739,37892.14063,194.6590368,1494,607,1529,1008.933595,16571.52734,922,-108,276.4313602,14561.05249,662,4583058,65148608,4890515
11016,1,-1313,121,281.33768080000004,43423.984130000004,208.38422240000003,1434,549,1352,1005.2293119999999,13608.52734,803,-29,255.46764720000002,10887.30859,474,5065657,64671102,4176878
11017,1,-3343,1171,681.6891588999999,410432.9509,640.6504123999999,4514,196,2313,1129.636847,104070.1787,2117,-108,312.1415694,17157.53296,771,29740807,81669082,6235671
11018,1,-1727,353,378.8834955,95830.9353,309.5657205,2080,578,1500,994.9728403999999,22299.114990000002,922,-891,399.53091639999997,117644.7849,1692,9187373,63358141,10215997
11019,1,-757,636,284.70582410000003,59977.99609,244.9040549,1393,529,1558,1022.042983,34389.82202,1029,-1445,472.3059952,161886.2927,2504,5187674,66852599,14276669
11020,1,-636,1040,371.5263912,115909.9451,340.4554965,1676,607,1568,1000.173743,30214.857180000003,961,-801,431.9940682,100733.2461,2147,8834039,64022241,11943608
11021,1,-666,1444,393.514096,137454.085,370.74800739999995,2110,705,2019,1027.218681,32741.25684,1314,-1366,442.7496471,130906.5898,2395,9910614,67531406,12545744
11022,1,-404,333,228.1893745,22888.142330000002,151.2882756,737,823,1784,1011.1234699999999,17333.09351,961,-990,369.0949446,64163.9978,1752,3332505,65431723,8718789
11023,1,-2656,686,549.2170706,276452.7087,525.7877031,3342,205,1823,1044.279319,41207.16772,1618,-445,282.4777093,29112.39063,1128,19304921,69793235,5106794
11024,1,-2838,565,653.3590728999999,350658.94700000004,592.1646283,3403,19,1980,1012.1408849999999,65774.00366,1961,-495,354.68341960000004,46478.88647,1287,27320197,65563467,8051221
11025,1,-3070,555,726.746345,477225.4023,690.8150276,3625,-205,2068,1018.798641,81252.72241,2273,-455,350.728973,54563.171879999994,1425,33802256,66428843,7872692
11026,1,-1898,313,408.1982706,108416.7263,329.266953,2211,441,1362,1008.82382,18600.30859,921,-59,289.4584383,12880.4834,643,10664053,65134432,5362316
11027,1,-3171,656,645.6533512999999,338328.1875,581.6598554999999,3827,49,1284,984.0979212999999,33843.15625,1235,-89,280.4427861,22271.58984,643,26679568,61980718,5033482
11028,1,-2101,292,424.33989180000003,122449.3428,349.9276251,2393,372,1539,1003.3941689999999,40480.140380000004,1167,-237,345.4207579,36551.40234,979,11524118,64435191,7636192
11029,1,-1555,202,316.5102437,56425.861079999995,237.5412829,1757,696,1382,997.8205077,9751.915771,686,-59,276.1039207,16910.68359,603,6411439,63721329,4878936
11030,1,-1696,252,409.9511023,104335.2148,323.0096204,1948,568,1313,977.000072,16567.15601,745,-9,283.4544992,11464.8103,533,10755834,61089865,5142173
11031,1,-1616,90,290.6331988,45720.194339999995,213.82281060000003,1706,803,1401,1016.321907,7880.527344,598,-326,286.23588939999996,24143.33179,1078,5405930,66106254,5243583
11032,1,-2353,585,734.9125692000001,437145.7458,661.1699826,2938,-49,1725,1025.734257,64374.30835,1774,-445,399.9891795,70291.09375,1504,34566175,67336369,10239446
11033,1,-2797,838,619.4931144,330193.9365,574.6250399,3635,-68,2068,1049.063556,83083.87109,2136,-970,449.868123,135550.9998,2514,24561390,70434198,12952405
11034,1,-2212,565,609.4259337999999,319116.2881,564.9037866,2777,117,1686,1018.824391,80754.92554,1569,-841,499.0195074,175002.4648,3217,23769598,66432201,15937310
11035,1,-3181,424,498.9164509,211172.4209,459.5350051,3605,117,1568,1019.214457,41827.06226,1451,-584,401.7129144,92228.91967999999,1910,15930728,66483079,10327889
11036,1,-2282,252,366.5945691,101182.2107,318.0915131,2534,696,1372,1007.448727,12451.375,676,-237,247.80158390000003,17121.68359,959,8601061,64956988,3929960
11037,1,-525,333,225.0578051,14794.04272,121.63076389999999,858,794,1303,996.3708992,6457.703125,509,-188,316.2915981,23950.600590000002,861,3241665,63536318,6402584
11038,1,-2949,575,559.7682696,262708.4841,512.5509576000001,3524,49,1588,1027.656664,55077.96875,1539,-524,349.2416338,59610.26465,1603,20053793,67589006,7806062
11039,1,-2505,616,625.2130137,345108.6865,587.4595191000001,3121,-58,1970,1027.192107,114829.7773,2028,-702,445.3216359,156100.3728,2256,25017044,67527912,12691927
11040,1,-2808,717,688.1378745000001,372796.9255,610.5709832,3525,-127,1578,1020.5405119999999,82939.55859,1705,-1059,521.1947962,193305.2537,2811,30306159,66656188,17385217
11041,1,-2949,636,497.92190030000006,218040.4531,466.9480197,3585,137,2019,1047.885535,103992.7803,1882,-514,349.69147119999997,69484.70215,1464,15867278,70276102,7826184
11042,1,-2191,545,585.9643494,257395.3086,507.34141229999994,2736,107,1549,1005.283581,50899.32397,1442,-168,361.15117589999994,36631.53882,1019,21974670,64678085,8347531
11043,1,-1959,303,470.448174,157856.8533,397.3120351,2262,343,1647,1016.2825330000001,36826.1875,1304,-158,295.0429789,26141.66187,880,14164575,66101132,5571223
11044,1,-1494,191,442.1379168,111186.4443,333.44631400000003,1685,588,1303,964.8268788999999,18089.80371,715,-89,297.14046030000003,27012.9978,752,12511100,59577018,5650717
11045,1,-1797,262,346.8909681,81794.74609,285.99780780000003,2059,450,1480,1029.913657,22584.03491,1030,-306,299.3438397,26942.564210000004,1018,7701334,67886217,5734831
11046,1,-2090,434,467.028355,158144.0662,397.6733159,2524,274,1441,1007.33734,32678.48413,1167,-217,333.4116965,49651.609130000004,1038,13959391,64942625,7114455
11047,1,-2313,393,540.8656834,219348.5303,468.346592,2706,264,1519,978.5464986,38351.6875,1255,-227,282.4217535,30137.523189999996,850,18722284,61283408,5104771
11048,1,-2494,707,600.4785982000001,286258.6755,535.0314715,3201,29,2196,1042.763756,144211.7881,2167,-544,416.3622972,125437.6162,2187,23076771,69590800,11094884
11049,1,-2383,606,682.6016179,345839.4023,588.0811187999999,2989,49,1529,986.1709490000001,61790.970460000004,1480,-405,402.1697986,89623.1228,1474,29820478,62242121,10351395
11050,1,-1060,141,304.7736865,37735.413089999995,194.2560503,1201,676,1362,1006.9279630000001,12309.53687,686,-128,288.9585286,17656.67871,850,5944768,64889851,5343810
11051,1,-2181,474,410.1362578,104471.2803,323.2201731,2655,549,1460,994.0743889,21741.29077,911,-217,288.7576298,15894.6709,712,10765552,63243769,5336382
11052,1,-2636,353,519.6374036000001,209936.7656,458.1885699,2989,235,1549,999.4861883,44107.76733,1314,-227,315.4047747,39064.068119999996,1038,17281474,63934249,6366731
11053,1,-1969,262,494.90835639999995,162457.6211,403.06031939999997,2231,284,1303,997.8388757000001,37883.782960000004,1019,-386,356.13998300000003,61603.33496,1574,15675794,63723675,8117484
11054,1,-1464,252,335.3505395,76614.84546,276.7938682,1716,490,1372,1029.567332,29815.60913,882,-138,287.2992506,18444.861080000002,613,7197439,67840569,5282615
11055,1,-2696,808,910.1613267000001,733481.5095,856.4353505,3504,-176,2294,1058.634454,143945.3086,2470,-396,349.1206588,62250.06812,1138,53017193,71725242,7800655
11056,1,-3474,868,724.9680489,460306.406,678.4588462,4342,-156,1980,1040.28191,102426.7361,2136,-287,416.3756004,84760.09546,1742,33637035,69259933,11095593
11057,1,-3141,858,826.3333543,591849.1719,769.3173415,3999,-176,2196,1026.299801,124838.5898,2372,-376,397.1044809,67166.20313,1772,43700916,67410642,10092286
11058,1,-2606,777,584.5728275,295695.0291,543.7784742,3383,411,1803,1007.1939359999999,55998.625,1392,-59,329.02968139999996,28171.53125,732,21870425,64924136,6928674
11059,1,-2414,545,514.2699163999999,186641.2654,432.01998260000005,2959,519,1549,991.5946989,27478.855219999998,1030,-19,300.9188792,18602.49194,801,16926307,62928643,5795339
11060,1,-1696,494,430.55982819999997,128133.7263,357.9577158,2190,607,1490,1005.5141869999999,32443.21875,883,9,283.54102989999996,14835.51343,495,11864433,64707762,5145313
11061,1,-2888,606,654.9728643999999,380706.2576,617.0139849,3494,-107,2509,1048.140906,108045.6951,2616,-1069,519.4019247,201665.5154,2969,27455325,70310359,17265815
11062,1,-2191,656,559.5937421,260230.7803,510.12819979999995,2847,-147,2029,1044.544062,103377.9548,2176,-821,466.7134761,133031.3086,2157,20041290,69828627,13940574
11063,1,-2505,707,654.5922992000001,363792.3865,603.1520426,3212,-186,2294,1041.871243,160232.0537,2480,-772,491.85756,169655.2986,2138,27423429,69471724,15483127
11064,1,-2979,545,730.8807935,398889.2048,631.5767607999999,3524,-137,1882,1001.494508,113388.5898,2019,-207,363.66715120000003,54978.48413,1078,34187951,64191440,8464243
11065,1,-2212,323,447.5415658,137988.613,371.4681858,2535,500,1970,1031.938089,37397.225589999995,1470,-19,283.6051668,11386.11694,514,12818781,68153358,5147641
11066,1,-2101,434,455.5494107,142667.5017,377.713518,2535,303,1549,1010.404398,23633.948969999998,1246,-158,292.7206433,18620.56152,831,13281617,65338691,5483864
11067,1,-2393,636,506.7789829,227219.4336,476.6753965,3029,-68,1764,1016.013426,68388.8584,1832,-1029,483.2421915,151198.8533,3464,16436796,66066130,14945473
11068,1,-2353,727,407.9044389,146601.8506,382.886211,3080,382,1745,1018.3576310000001,39706.751710000004,1363,-118,308.4747001,22079.34546,672,10648706,66371345,6090025
11069,1,-2666,414,588.8092194,265889.3513,515.6445978999999,3080,245,1539,1010.6218230000001,38284.21875,1294,-267,349.0968705,42132.98438,1158,22188563,65366814,7799592
11070,1,-1686,494,317.03945439999995,98962.39429,314.5828894,2180,715,1470,1015.526688,18094.9314,755,-1039,358.4891691,72619.1814,1652,6432897,66002845,8224927
11071,1,-1313,757,336.748492,109127.69900000001,330.34481830000004,2070,284,2029,1046.159255,46641.04688,1745,-871,319.297887,44028.189210000004,1554,7257571,70044748,6524873
11072,1,-1343,1020,288.57169819999996,82128.22559,286.58022539999996,2363,235,2480,1049.3713300000002,58483.921879999994,2245,-118,315.68063870000003,21263.01538,949,5329512,70475532,6377873
11073,1,-989,1959,347.82624069999997,120978.1709,347.8191641,2948,0,2098,1040.303546,57644.6709,2098,-158,264.1379256,15275.77734,781,7742918,69262814,4465206
11074,1,-70,-10,38.81043674,169.4335938,13.016666,60,980,1029,1007.787366,75.3125,49,227,258.7921463,199.58496090000003,60,96400,65000664,4286296
11075,1,-50,-20,37.27012879,63.64746094,7.977935882000001,30,980,1029,1009.4844449999999,94.77734375,49,237,261.1972435,151.92871090000003,50,88900,65219766,4366336
11076,1,-50,0,32.78719262,98.4375,9.921567416,50,980,1029,1010.976717,110.8845215,49,227,257.4689302,160.91308590000003,60,68800,65412731,4242576
11077,1,-2272,5131,1045.061003,1041892.465,1020.731338,7403,-823,3352,1186.478653,470041.9756,4175,-475,320.0569773,53013.62109,1267,69897760,90094822,6555934
11078,1,-2666,5111,1058.257154,1107318.662,1052.292099,7777,-1068,2343,1205.301291,423128.7712,3411,-950,376.24314780000003,79853.24121000001,1712,71674125,92976077,9059770
11079,1,-3565,5141,1010.2024470000001,974236.9412,987.0344174,8706,-1735,3078,1243.273904,629581.9131,4813,-1316,504.30928939999995,236250.2166,2137,65312575,98926720,16276983
11080,1,-565,515,204.77277800000002,31345.409910000002,177.0463496,1080,696,1627,1048.831582,22214.40234,931,-574,275.11352769999996,46590.5564,1593,2683641,70403052,4843997
11081,1,-2212,2191,610.7932087,370409.6523,608.612892,4403,-323,2833,1101.848787,167158.0898,3156,-1059,366.1725387,76369.77318999999,1801,23876374,77700528,8581269
11082,1,-252,595,222.0268143,32654.90625,180.70668569999998,847,558,1343,1025.111846,27311.08374,785,-79,295.9236863,21594.0896,732,3154938,67254675,5604533
11083,1,-3111,5111,1573.171096,2407794.39,1551.7069279999998,8222,-1833,3950,1741.45535,1943415.7519999999,5783,-2821,718.2662611000001,498461.7908,4058,158391507,194090671,33018011
11084,1,-4474,5121,1644.045164,2688775.515,1639.748613,9595,-2450,3549,1516.840075,1393488.03,5999,-1663,679.7526548999999,417681.033,3257,172984608,147251444,29572075
11085,1,-252,393,129.9853958,9737.456787000001,98.67855282,645,313,1352,1019.8241039999999,16308.286869999998,1039,138,304.21499900000003,4328.484131,366,1081357,66562637,5922993
11086,1,-2373,3939,717.7955946000001,488778.5427,699.1269861000001,6312,-235,2215,1095.536063,112513.2283,2450,-485,292.3062392,30261.991210000004,1069,32974753,76812753,5468348
11087,1,-1303,3252,705.0956717,449785.6631,670.6606168999999,4555,-450,2107,1080.734256,217300.5928,2557,-415,284.828896,54344.131839999995,1266,31818234,74751138,5192160
11088,1,-3494,2676,895.1819734999999,796587.6091,892.517568,6170,-1254,2235,1102.1053570000001,283169.9531,3489,-742,340.6006643,73958.18359,1940,51286449,77736718,7424564
11089,1,0,181,76.06052278,1912.085693,43.72740209,181,941,1068,1009.2439539999999,776.1208496,127,158,254.274458,1056.9648439999999,168,370253,65188695,4137952
11090,1,-40,131,48.13116844,1088.325928,32.9897852,171,960,1078,1009.4104169999999,544.5895996,118,108,275.0524666,2424.425537,278,148263,65210201,4841847
11091,1,-40,232,70.81644406,3192.746094,56.50439004,272,911,1068,1017.2150859999999,1136.600586,157,138,222.03360530000003,1276.30835,149,320958,66222498,3155131
11092,1,0,50,31.64747225,129.46777340000003,11.37839063,50,1000,1029,1012.015416,62.82788086,29,207,242.0167866,159.2773438,70,64100,65547213,3748616
11093,1,-10,40,19.803724399999997,91.38183594,9.559384705,50,990,1039,1013.147416,108.74121090000001,49,237,250.8017145,104.2724609,40,25100,65693932,4025696
11094,1,-10,50,20.53959591,137.109375,11.70937125,60,990,1039,1012.845396,98.28686523,49,227,249.3145603,141.18652340000003,40,27000,65654771,3978096
11095,1,-3151,1343,513.5212081999999,220414.0273,469.4827232,4494,323,2245,1007.779242,38116.02734,1922,-336,346.90357989999995,34034.6709,1751,16877058,64999616,7701894
11096,1,-2383,1343,455.31738590000003,183698.8767,428.60106940000003,3726,29,2303,1016.230174,52840.31616,2274,-425,378.06377599999996,39549.874019999996,1504,13268091,66094321,9147662
11097,1,-1797,939,366.71744910000007,114005.8662,337.64754730000004,2736,127,1676,1005.8796990000001,33178.40625,1549,-485,369.331258,39383.06226,1267,8606828,64754814,8729957
11098,1,-2343,1525,491.29929780000003,229040.1211,478.58136310000003,3868,-205,2068,1027.173785,61481.97437,2273,-574,395.9818296,56994.97827000001,1732,15448000,67525503,10035303
11099,1,-3050,1868,579.87275,321421.7334,566.9406789,4918,156,1450,1007.022933,35294.131839999995,1294,-376,384.8379935,44938.87109,1692,21520154,64902092,9478418
11100,1,-2909,1989,638.4106731,384615.9375,620.1741187000001,4898,-19,1696,1021.7023019999999,53726.21484,1715,-435,434.7864058999999,84467.82813,1989,26084364,66808038,12098510
11101,1,-2656,2222,699.7119497,474970.9336,689.1813503,4878,-568,3215,1110.066622,231935.3818,3783,-881,544.1250431,186386.9023,3415,31334196,78863866,18948612
11102,1,-272,20,144.60927959999998,3865.2773439999996,62.17135469,292,911,1058,988.5584992,856.890625,147,168,322.1922223,4139.36499,277,1338358,62543866,6643701
11103,1,-1464,767,290.47821560000006,73852.11621000001,271.75745839999996,2231,392,1686,1000.9633640000001,21703.90234,1294,-306,352.35551119999997,26087.569340000002,1038,5400166,64123370,7945882
11104,1,-202,151,110.0577263,3737.593506,61.13586105,353,931,1088,997.8905016000001,1309.054443,157,148,296.7607938,3367.780273,267,775213,63730269,5636286
11105,1,-111,30,60.44380138,487.63256839999997,22.08240404,141,980,1029,1000.3535390000001,113.3649902,49,247,295.8139196,222.5585938,89,233821,64045261,5600376
11106,1,-818,737,194.083302,36563.80444,191.2166427,1555,313,2617,1035.140291,65663.13452,2304,-376,429.74160109999997,96784.12402,2534,2410773,68576987,11819382
11107,1,-90,-10,51.15845482,225.36621090000003,15.01220207,80,960,1019,993.1788531999999,138.0036621,59,277,316.37613589999995,227.9841309,89,167500,63129871,6406007
11108,1,-70,-20,42.16781948,127.734375,11.30196333,50,970,1019,994.3027394,104.875,49,297,317.493184,124.6149902,39,113800,63272828,6451323
11109,1,-70,-20,45.38033715,117.87109380000001,10.85684548,50,960,1009,989.5218542000001,105.09277340000001,49,287,321.71520310000005,128.37475590000003,59,131800,62665824,6624043
11110,1,-70,-20,44.66892096,94.89746094,9.741532782,50,970,1009,990.7462859999999,85.52124023,39,287,325.0399735,157.97436519999997,69,127700,62821005,6761663
11111,1,70,464,335.4731267,6429.15625,80.18201949,394,823,1137,985.0781774000001,4673.58374,314,-128,81.31795235,3721.866943,306,7202702,62104257,423207
11112,1,-202,545,210.0549779,35785.12109,189.1695565,747,764,1196,1023.234333,7691.967773,432,-465,205.16917560000002,33610.25366,930,2823878,67008544,2694041
11113,1,-1808,909,368.4882546,125443.2461,354.1796805,2717,382,1578,1027.822866,26258.28027,1196,-445,249.5246418,29007.605219999998,1088,8690150,67610870,3984803
11114,1,-2606,898,444.80645369999996,191472.7656,437.5760113,3504,-127,1921,1023.578824,54732.49976,2048,-217,390.3434786,69388.02734,1444,12662578,67053671,9751554
11115,1,-2525,2666,573.6380337,309020.6523,555.8962604,5191,-254,1764,996.7691637,69276.83179,2018,-297,412.34612660000005,50237.62866,1574,21059878,63587121,10881877
11116,1,-464,70,156.5403303,10543.97559,102.6838623,534,813,1078,990.7543922,2824.126709,265,69,334.13877169999995,14791.6084,554,1568312,62822033,7145518
11117,1,-151,232,89.82656901,7293.538086,85.40221359,383,901,1088,995.6820605,1202.2907710000002,187,9,303.11046360000006,6200.83374,426,516404,63448497,5880061
11118,1,-1333,5040,976.3265974999999,904620.9336,951.1156258,6373,-509,2764,1167.381659,294657.6875,3273,-663,371.3056566,78324.26538,1375,61005672,87217916,8823545
11119,1,-3222,5151,1372.7424310000001,1845452.554,1358.474348,8373,-1137,2735,1272.665019,610153.6875,3872,-772,403.2091385,106711.8552,1772,120602994,103659280,10404967
11120,1,-5000,5151,1275.555192,1595905.342,1263.291471,10151,-4911,4764,1638.5019550000002,1785392.0590000001,9675,-3752,751.6619607000001,526757.1228,5435,104130627,171820074,36159725
11121,1,-4101,5161,1424.514753,2009140.358,1417.441483,9262,-1274,3588,1224.674753,591142.6875,4862,-1009,454.70232360000006,142515.7166,2652,129871506,95989008,13232269
11122,1,-1555,4272,688.8199488,459759.99,678.0560375,5827,-784,2421,1122.281632,233853.5,3205,-465,282.526741,23021.06421,1088,30366267,80609028,5108567
11123,1,-1222,4575,740.0290957000001,528831.2256,727.2078283,5797,-421,3735,1168.10016,352390.5466,4156,-584,345.9418981,70965.92749,1613,35049156,87325311,7659251
11124,1,-3858,5101,1211.868031,1419783.125,1191.546527,8959,-1617,3411,1332.320901,818808.9099,5028,-1178,410.1459915,137600.2029,1999,93991944,113605055,10766063
11125,1,-3494,5101,1184.404116,1379561.625,1174.547413,8595,-745,3558,1233.496232,487382.8533,4303,-891,361.36929260000005,81726.04467999999,1623,89780039,97376829,8357617
11126,1,-2515,4494,884.0182848999999,757863.6775,870.5536615,7009,-784,2009,1105.110762,216858.6931,2793,-732,353.9284444,59360.82715,1840,50015253,78161267,8016982
11127,1,-1555,5090,1208.87604,1371362.53,1171.051891,6645,-1401,3343,1199.242411,487039.3201,4744,-900,409.0947896,106973.1638,2098,93528402,92043671,10710947
11128,1,-1323,313,231.16038799999998,51426.96484,226.77514159999998,1636,696,1931,1038.445172,21712.87109,1235,-1069,321.5513421,59890.4314,2227,3419848,69015576,6617297
11129,1,-737,868,288.2731452,78227.62109,279.6920111,1605,470,1980,1041.974043,59794.140629999994,1510,-29,298.3696847,22573.2959,672,5318490,69485434,5697566
11130,1,-4979,5181,1932.6415170000002,3695296.75,1922.315466,10160,-3715,3970,1843.593184,2370798.26,7685,-1643,622.5016943,336199.031,3108,239046607,217525493,24800535
11131,1,-2181,3040,747.9004362000001,554658.5303,744.7540066,5221,-205,1872,1083.647717,232058.1523,2077,-267,334.0650199,27354.375,960,35798724,75154712,7142364
11132,1,-3333,4959,1213.886508,1458441.381,1207.659464,8292,-509,2450,1128.70319,402519.4685,2959,-514,357.3038142,70656.99193999999,1514,94305309,81534137,8170625
11133,1,-1222,4191,765.2383003,550550.4961,741.9909002999999,5413,-500,2627,1188.618105,347982.4912,3127,-633,351.15552560000003,70947.89233,1633,37477738,90420032,7891853
11134,1,-5000,5000,1234.287655,1496585.388,1223.350068,10000,-2362,2921,1250.559019,650290.4548,5283,-980,439.03970139999996,115584.7556,2455,97501825,100089463,12336375
11135,1,-707,2565,431.6616695,159389.6521,399.2363361,3272,509,1882,1059.983933,47289.37109,1373,-178,236.70158560000002,18191.31226,544,11925235,71908220,3585769
11136,1,-1484,1868,661.6451324,391978.2813,626.081689,3352,-794,2205,1261.7459509999999,510987.7646,2999,-594,328.9978391,70500.44507,1326,28017554,101888182,6927333
11137,1,-4989,5141,1522.226684,2312942.982,1520.8362769999999,10130,-3372,4039,1570.082527,1825434.111,7411,-1168,427.3092411,136421.9219,2425,148299141,157770185,11685964
11138,1,-4020,5141,1086.547636,1162975.646,1078.413486,9161,-1245,2843,1248.40308,627224.9365,4088,-633,370.11237739999996,85006.29663,1464,75557489,99744656,8766923
11139,1,-5000,5171,1686.22196,2809338.835,1676.108241,10171,-4127,4725,1683.512432,1961887.2969999998,8852,-1663,550.7931922,260452.9548,2771,181974048,181389703,19415881
11140,1,-4979,5161,1683.740061,2821676.413,1679.7846329999998,10140,-2931,3558,1752.8527329999997,2078140.955,6489,-2742,803.6183212999999,605426.5273,4138,181438758,196639533,41331354
11141,1,-2373,4919,1152.284911,1269355.22,1126.656656,7292,-990,4127,1280.584376,552503.6084,5117,-1128,338.09738799999997,88197.30371000001,1860,84976673,104953366,7315830
11142,1,-20,333,120.31144479999999,3351.186523,57.88943361,353,950,1078,1001.7454449999999,616.8710937999999,128,138,274.3918844,2069.928711,218,926390,64223612,4818618
11143,1,-141,484,191.9138804,15941.65527,126.260268,625,715,1225,1001.9706359999999,10123.08496,510,-19,258.2736557,11627.05859,523,2357180,64252490,4269138
11144,1,-40,414,172.3555101,8102.015381,90.01119586,454,852,1245,1014.87684,3489.413086,393,79,231.3131333,3000.226318,247,1901211,65918400,3424369
11145,1,-787,1242,353.1250442,112778.7986,335.82554780000004,2029,137,1843,1058.935506,91436.56934,1706,-326,285.09677630000004,28874.94702,900,7980627,71766042,5201931
11146,1,-191,1090,335.110686,74341.17358,272.6557786,1281,49,1441,1022.5308289999999,70814.17749,1392,-198,249.8863179,16238.32593,663,7187147,66916435,3996363
11147,1,-292,1323,352.7496235,71640.05443999999,267.656598,1615,-58,1627,1023.634227,77047.88965,1685,-237,242.9769472,15297.99585,662,7963667,67060930,3778419
11148,1,-1363,3121,776.5266012999999,559716.5615,748.1420731000001,4484,-362,2127,1097.003774,227396.7773,2489,-178,317.48321810000004,45408.913089999995,890,38591588,77018706,6450918
11149,1,-1595,3202,617.7905819,357548.0837,597.9532454,4797,-245,2039,1086.229869,171785.2009,2284,-425,315.8956018,40573.850589999995,1207,24426573,75513301,6386562
11150,1,-161,595,253.51254280000003,28777.581789999997,169.63956430000002,756,617,1245,1004.0401199999999,26511.0,628,-19,232.79527620000002,6157.329834,484,4113191,64518180,3468393
11151,1,-808,1959,429.5584215,167733.9961,409.5534106,2767,303,1598,1046.933827,54139.875,1295,-148,290.6519611,22570.90234,1148,11809308,70148508,5406628
11152,1,-262,636,231.5721405,33212.39063,182.2426696,898,549,1235,1012.905544,24445.80444,686,-19,235.24385619999998,7645.206787,365,3432042,65662569,3541739
11153,1,-20,313,144.58696559999998,4541.384521,67.38979538,333,901,1196,1008.1536570000001,2230.388428,295,128,249.11568599999998,1696.277344,208,1337945,65047923,3971752
11154,1,-40,383,150.76616830000003,7230.1875,85.03050923,423,823,1137,1010.9172970000001,4566.350586,314,108,240.76755519999998,1733.3396,218,1454748,65405042,3710017
11155,1,30,363,173.6641874,6356.545897999999,79.72794929,333,823,1107,1000.845744,4471.519287,284,69,222.35890890000002,1953.5407710000002,218,1930192,64108301,3164383
11156,1,-979,1414,389.7023704,137400.3584,370.6755433,2393,284,1392,1036.724017,70479.53809,1108,-207,296.6698238,25098.236080000002,1018,9719548,68786988,5632831
11157,1,-414,929,301.88944060000006,78286.88647,279.79793870000003,1343,343,1843,1059.307844,72308.73804,1500,-237,287.50154889999993,29389.94312,870,5832783,71816519,5290057
11158,1,-414,696,277.72884710000005,55266.296879999994,235.08784930000002,1110,382,1735,1040.126382,54965.667720000005,1353,-79,273.76860669999996,19547.85938,920,4936532,69239225,4796752
11159,1,-171,707,262.6622118,42534.381839999995,206.2386526,878,568,1225,1029.897075,33664.08765,657,-118,243.5611127,12483.58765,474,4415452,67884031,3796609
11160,1,-515,1878,469.0001666,174924.3584,418.2395945,2393,-78,1725,1030.247346,133980.4053,1803,-207,267.8734543,32192.491210000004,1068,14077514,67930214,4592396
11161,1,0,898,286.1693118,38237.99609,195.54538119999998,898,362,1215,1009.354597,40521.16577,853,-207,228.3319951,14134.87109,583,5241144,65202989,3336672
11162,1,-979,1606,412.0261862,150073.5955,387.39333430000005,2585,49,1735,1054.5022,70458.96655,1686,-297,299.3901875,36468.21265,1287,10864997,71166393,5736607
11163,1,-262,1090,301.95306960000005,75464.60059,274.7082099,1352,196,1460,1051.971356,69460.6189,1264,-247,281.8089446,19880.28125,722,5835242,70825199,5082642
11164,1,-969,3181,593.4507667,334286.3896,578.1750509999999,4150,-421,1745,1041.183034,108257.7048,2166,-128,292.0452127,20472.42871,1157,22539764,69379975,5458586
11165,1,-1101,4909,827.6934064,637429.6709,798.3919281000001,6010,-147,1931,1114.943566,151008.8428,2078,-663,337.14506800000004,81631.39038,1474,43844888,79558346,7274675
11166,1,-10,454,221.71384989999999,9356.78125,96.73045668,464,813,1196,1005.6658550000001,5542.866211,383,29,194.1029447,4055.292725,297,3146050,64727284,2411261
11167,1,121,363,205.9436361,2412.78125,49.12006973,242,892,1078,1000.97689,1673.4646,186,108,201.6961669,1130.078125,169,2714418,64125103,2603606
11168,1,-1151,393,220.59153430000003,44192.538089999995,210.22021329999998,1544,549,2127,1037.757724,38261.631839999995,1578,-841,393.2802754,79713.20215,1870,3114280,68924230,9898840
11169,1,-1535,787,305.3467291,92063.5625,303.4197793,2322,382,1715,1029.8558679999999,36111.20483,1333,-1851,457.0296592,138841.449,2959,5967144,67878599,13368071
11170,1,-212,434,120.7693437,14283.88647,119.5152144,646,696,1147,1013.6415480000001,5916.795897999999,451,-69,274.58326380000005,9298.772461,455,933455,65758028,4825342
11171,1,-2121,1383,424.35007289999993,178182.0935,422.11620849999997,3504,-186,1823,1019.751839,55705.80859,2009,-554,340.2944727,47589.57983,1474,11524671,66553204,7411221
11172,1,-1111,1090,343.9878722,113130.1475,336.3482532,2201,-127,2754,1077.53929,120914.0349,2881,-1009,432.47783539999995,105892.2146,2801,7572970,74309819,11970373
11173,1,-2101,1373,403.075811,160524.4724,400.65505410000003,3474,-88,3627,1086.616825,150130.4648,3715,-881,420.4470091,98445.67188,2445,10398087,75567112,11313644
11174,1,-1141,1070,331.9482264,99197.41309,314.9562082,2211,68,1470,986.7900296,49813.07715,1402,-485,412.190471,71236.28491,1881,7052136,62320292,10873663
11175,1,-2000,1464,425.9433464,175758.115,419.2351548,3464,176,2470,1060.5295039999999,78673.30443999999,2294,-1366,538.0135773,186046.1189,3880,11611375,71982261,18525351
11176,1,-1333,1262,418.5027442,163591.656,404.4646536,2595,-137,1911,980.4206049000001,79444.87402,2048,-584,527.5280650000001,144135.3513,3049,11209251,61518372,17810295
11177,1,-1363,1020,346.5765608,103060.585,321.0305047,2383,29,1882,1028.340433,57827.767329999995,1853,-861,490.7918188,124008.7771,2286,7687380,67678979,15416103
11178,1,-2494,2454,510.4526637,260464.0974,510.35683339999997,4948,-607,2352,1017.510358,84367.14233,2959,-960,477.51413590000004,129619.9023,2603,16675963,66260949,14593264
11179,1,-727,232,172.3342047,22951.99585,151.4991612,959,656,1735,1008.558307,16846.079830000002,1079,-336,338.9449854,25921.320069999998,1068,1900741,65100151,7352557
11180,1,-1666,1171,332.3925108,109106.5156,330.3127543,2837,147,2176,1027.473616,55702.03125,2029,-475,383.72231170000003,60751.67871,1950,7071026,67564930,9423540
11181,1,-202,90,113.29986480000001,2657.941162,51.55522439,292,931,1078,993.3930727,873.8884277000001,147,168,322.84770499999996,3255.648193,297,821559,63157107,6670761
11182,1,-1979,1070,448.97254230000004,172420.7813,415.235814,3049,0,2245,1012.2422740000001,77814.20092999999,2245,-653,484.5977552,103394.7478,2108,12900886,65576603,15029439
11183,1,-1787,1282,417.0934398,156094.5898,395.0880786,3069,147,1901,1010.4535800000001,51530.04688,1754,-227,416.791802,61134.18652,1870,11133884,65345052,11117786
11184,1,-777,393,204.63317030000002,32371.531010000002,179.9209021,1170,725,1450,1003.900954,9691.246094,725,-396,315.6326484,21695.756840000002,950,2679983,64500296,6375934
11185,1,-2626,2616,585.2435791,339016.1287,582.2509156000001,5242,-39,1980,1020.0544560000001,55144.663089999995,2019,-237,410.68019039999996,83849.8584,2118,21920643,66592710,10794126
11186,1,-585,1404,251.2862225,61392.55835,247.7752174,1989,205,1921,1025.985913,49519.65234,1716,-485,370.02434460000006,54952.114989999995,1524,4041265,67369414,8762753
11187,1,-1292,2252,469.3772304,196256.0662,443.00797530000006,3544,-88,1745,1083.751745,106266.4023,1833,-99,251.28575619999998,14455.35059,613,14100159,75169142,4041250
11188,1,60,121,86.5517367,274.16967769999997,16.55806987,61,990,1049,1014.856779,153.29589840000003,59,198,221.73837340000003,188.6835938,69,479437,65915794,3146746
11189,1,-262,585,198.0370467,27712.757569999998,166.4714918,847,666,1313,1021.7728539999999,14143.64233,647,-168,273.1087238,21212.93652,791,2509995,66817265,4773656
11190,1,-535,2787,505.2447117,207965.9688,456.03285930000004,3322,-352,1676,1066.116316,158112.0898,2028,-574,305.98562569999996,59742.44702000001,1445,16337422,72742656,5992141
11191,1,-3323,5030,1213.555308,1395319.506,1181.236431,8353,0,2558,1203.702887,333005.5115,2558,-871,312.03878460000004,76726.59546,1366,94253855,92729641,6231565
11192,1,-3464,5141,1452.999043,2091404.4519999998,1446.1688880000002,8605,-2970,4686,1807.079144,2116886.969,7656,-2000,678.9350807,446251.2813,3306,135117198,208994242,29500982
11193,1,-4868,5161,1244.703322,1547647.375,1244.044764,10029,-1313,4705,1412.302027,975349.0251,6018,-732,355.0673132,74110.16967999999,1464,99154327,127654209,8068659
11194,1,-2484,5151,1459.627184,2042775.2240000002,1429.256878,7635,-2647,4049,1609.480157,1540890.155,6696,-1683,499.35408279999996,245731.9648,2653,136352737,165787288,15958688
11195,1,-5000,5161,1892.2128870000001,3548991.088,1883.876612,10161,-3186,4784,1857.693164,2657115.047,7970,-1712,708.0963917,471244.0068,4355,229150055,220865529,32089632
11196,1,-1646,5090,769.1459346,581827.7334,762.7763325,6736,-774,2441,1151.586562,318919.8318,3215,-821,350.49708010000006,91646.29272,1692,37861470,84873703,7862285
11197,1,-171,3000,568.2986258,201478.4041,448.8634581,3171,-568,1715,1068.863123,230503.0615,2283,-1118,282.8256696,77969.57592999999,1484,20669653,73117976,5119383
11198,1,-3222,5171,1445.052719,1967757.515,1402.7678050000002,8393,-441,2460,1274.430112,463940.1833,2901,-1495,508.13951389999994,251453.5486,2356,133643351,103947015,16525169
11199,1,-1828,2878,656.6533284,386698.9648,621.8512401,4706,-421,1833,1075.232053,143836.4531,2254,-673,251.18431980000003,36626.33984,1296,27596390,73991934,4037988
11200,1,-3232,5121,1010.6674,937475.4209,968.2331439,8353,-1029,2333,1116.0108369999998,287895.6211,3362,-1069,261.35141569999996,60978.27246,1484,65372710,79710732,4371492
11201,1,-2616,4272,859.4010632000001,713616.0615,844.7579899,6888,-205,2264,1131.611786,193119.9119,2469,-683,313.8523986,40414.796630000004,1336,47268492,81954895,6304213
11202,1,-3030,5060,1045.602241,1061827.699,1030.450241,8090,-539,2333,1162.40388,352182.5313,2872,-831,316.9598999,74938.52318999999,1296,69970179,86475698,6429669
11203,1,-818,2767,450.5960982,157374.4961,396.7045451,3585,-225,1441,1046.291068,101401.3193,1666,-752,241.1700969,39218.07397,1326,12994358,70062400,3722433
11204,1,-505,3959,609.3814102000001,305753.6912,552.9499897000001,4464,-833,1862,1122.614693,160190.5381,2695,-772,225.5318367,33797.63647,1227,23766125,80656880,3255335
11205,1,-333,1323,458.8249768,104661.6365,323.51450739999996,1656,-127,1411,1016.6742119999999,136491.8923,1538,-366,160.4379748,19945.32813,722,13473303,66152093,1647382
11206,1,-70,636,313.7901867,23644.93652,153.76910130000002,706,519,1500,1039.4340710000001,39640.65234,981,-118,127.3387461,8432.608398,454,6301714,69147084,1037770
11207,1,-1202,3101,586.8127628999999,312252.2568,558.7953622,4303,29,1509,1063.7144529999998,80991.55859,1480,-366,252.8852259,25154.24902,831,22038350,72415260,4092860
11208,1,-868,2616,593.6551635,305858.1619,553.0444484,3484,-264,1882,1046.964713,119157.3064,2146,-702,238.54883540000003,34578.65015,1226,22555293,70152647,3641955
11209,1,70,464,252.1623671,8221.23999,90.67105376,394,784,1117,1009.261983,5190.027344,333,39,127.9478043,2714.5271,218,4069495,65191024,1047721
11210,1,-373,1212,440.6088295,125909.0681,354.83667810000003,1585,-254,1852,1127.452861,181898.9705,2106,-346,189.10591440000002,27138.18335,801,12424713,81353597,2288707
11211,1,-5000,5151,1257.119805,1503248.533,1226.070362,10151,-3039,3813,1387.259692,1094539.9840000002,6852,-1386,437.072988,171768.2244,2643,101142413,123167325,12226099
11212,1,-1020,2686,534.3362850999999,258099.1501,508.0345954,3706,68,1921,1071.083396,93549.46851,1853,-386,271.54177860000004,30730.54688,1098,18272977,73422057,4719036
11213,1,-1545,5070,947.7775731,805266.8591,897.3666247000001,6615,-549,2500,1144.879128,344950.6563,3049,-1376,389.7388348,130767.0115,2603,57490069,83887886,9721367
11214,1,-3323,4939,1092.837698,1157292.105,1075.775118,8262,-813,2411,1192.823724,294519.7646,3224,-1702,417.8000419,124827.875,3098,76434831,91061020,11171640
11215,1,-979,3959,787.8169104,550289.6326,741.8150932,4938,-254,2117,1071.8583310000001,193007.4336,2371,-772,275.5236208,58003.298579999995,1306,39721951,73528338,4858449
11216,1,-4606,5141,1292.28475,1620215.1090000002,1272.876706,9747,-1068,2990,1216.689598,372083.9138,4058,-643,331.47218960000004,69221.17188,1266,106879992,94741349,7031924
11217,1,-1212,4898,779.4622746,556992.6719,746.3194168,6110,-323,1901,1103.7916050000001,208770.5459,2224,-801,295.03450539999994,54909.19507,1365,38883932,77974778,5570903
11218,1,-212,2242,512.0573241000001,151573.7068,389.3246804,2454,-852,1715,1060.746494,245690.8398,2567,-405,213.1558262,32138.433589999997,840,16780973,72011720,2907866
11219,1,-1464,5151,1220.226766,1392280.947,1179.949553,6615,-1411,3156,1337.663968,923950.7576,4567,-1574,404.59765889999994,146097.4392,2187,95293015,114518073,10476753
11220,1,-2070,5131,1261.712657,1526310.8080000002,1235.43952,7201,-794,3039,1216.030029,464365.3193,3833,-940,495.92758729999997,200754.7126,3326,101882805,94638658,15740427
11221,1,-525,888,359.0846001,59179.734379999994,243.268852,1413,372,2117,1047.956553,69953.56152,1745,-346,253.8017496,34567.36694,1435,8252272,70285628,4122581
11222,1,-1010,4111,705.0559597,389027.3438,623.7205654,5121,-411,1607,1096.6615960000001,274755.8896,2018,-1108,317.8197209,87596.83984,1692,31814650,76970666,6464600
11223,1,-2909,3979,896.4307958999999,758451.8416,870.8914063,6888,-411,3088,1168.2305,311316.8594,3499,-1217,390.61437989999996,102780.8818,2613,51429643,87344800,9765094
11224,1,-1343,5070,860.1970432,605467.7712,778.1180959,6413,-1666,2313,1234.555784,615650.9333,3979,-1554,393.89657989999995,152767.2771,2445,47356093,97544191,9929889
11225,1,-5000,5131,1445.8967910000001,2061012.0269999998,1435.622523,10131,-4098,4735,1464.630868,1204395.135,8833,-1801,565.5131934,271136.6755,3147,133799522,137289189,20467531
11226,1,-1282,3828,743.0139425,487870.8281,698.4775072000001,5110,-1696,2745,1354.589012,826989.5134,4441,-1316,376.2542981,125844.48800000001,2068,35332462,117434329,9060307
11227,1,-5000,5141,1505.925878,2214711.309,1488.190616,10141,-3147,4676,1517.847139,1627559.2969999998,7823,-1712,571.652238,298918.1523,3117,145140016,147447036,20914322
11228,1,90,313,153.36904019999997,1802.671875,42.45788354,223,941,1068,1009.141026,568.3708496,127,99,223.4975182,1447.960693,198,1505412,65175399,3196873
11229,1,30,343,191.17330980000003,4399.86499,66.33147812,313,803,1215,1010.260502,5507.061522999999,412,-99,181.3754738,5341.0625,386,2339023,65320082,2105412
11230,1,80,252,169.84740390000002,744.7614746,27.29031833,172,960,1068,1013.3484490000001,484.47241210000004,108,79,180.71502949999999,890.4294434000001,168,1846281,65720005,2090107
11231,1,-1727,2030,513.8847754999999,236976.1719,486.8019843,3757,0,1941,1066.640645,92950.80835,1941,-178,232.5307775,13279.186520000001,643,16900964,72814225,3460516
11232,1,-232,1050,300.4782126,57333.56152,239.4442764,1282,215,1490,1038.391545,64648.51465,1275,-405,247.3307818,30552.98413,791,5778378,69008448,3915041
11233,1,-80,868,369.2759596,40932.00952,202.3166071,948,235,1313,1004.347899,58668.521239999995,1078,-356,181.8124033,22949.21777,722,8727343,64557741,2115568
11234,1,-141,1515,444.51502719999996,99438.67749,315.33898819999996,1656,-715,1666,1081.150826,194748.9529,2381,-613,218.3923505,41828.61621,1088,12645991,74808775,3052494
11235,1,-20,888,395.2445841,32929.51563,181.46491569999998,908,245,1343,999.803426,54306.44507,1098,-277,126.09972490000001,12418.296629999999,613,9997970,63974841,1017673
11236,1,-1818,4171,1030.854401,1013854.322,1006.903333,5989,-392,2480,1159.3178289999998,319209.5955,2872,-633,327.899208,78282.23413,1504,68010291,86017141,6881145
11237,1,-383,595,268.5077687,36499.345460000004,191.0480187,978,588,1372,1019.258224,24051.45679,784,-267,248.60746540000002,21699.351319999998,712,4614171,66488789,3955563
11238,1,-10,1060,378.048112,60479.609379999994,245.9260242,1070,78,1421,1027.213806,97369.56421,1343,-356,203.7880716,30422.394289999997,702,9146904,67530765,2657893
11239,1,-2232,4696,848.2627652000001,633755.6475,796.0877134,6928,-313,2176,1082.777036,135986.6697,2489,-1376,313.05942430000005,87877.66772,1920,46051182,75033991,6272397
11240,1,151,454,258.2481849,4675.561522999999,68.3780778,303,784,1186,1003.8966109999999,5369.420897999999,402,0,126.35861659999999,1738.483398,217,4268296,64499738,1021856
11241,1,40,878,361.7072582,34101.421630000004,184.6657024,838,176,1362,1004.3256130000001,59202.39746,1186,-336,142.26235669999997,16148.57593,613,8373257,64554876,1295269
11242,1,-424,2222,702.3895821000001,341908.5381,584.7294572000001,2646,-1009,2294,1246.389404,639819.4021,3303,-910,412.0280065,169765.8474,1583,31574472,99423139,10865093
11243,1,-1161,5151,1001.0974679999999,923419.4392,960.9471572999998,6312,-539,3254,1126.5775119999998,265579.9119,3793,-1396,331.90560120000004,98215.52124,2247,64140553,81227321,7050325
11244,1,-141,1555,443.0673799,102796.9744,320.61967250000004,1696,-568,1421,1056.06053,155598.7031,1989,-643,208.928853,35865.96069,1088,12563757,71376886,2793681
11245,1,-292,1171,413.21751989999996,82966.13965,288.03843430000006,1463,-274,1607,1069.314098,152941.1794,1881,-544,232.13671209999998,41590.72241,1256,10927918,73179689,3448797
11246,1,20,111,75.31454873,265.4365234,16.29222279,91,970,1019,995.7818457999998,156.77124019999997,49,267,308.28198330000004,270.0068359,79,363026,63461215,6082418
11247,1,50,131,94.61178904,311.10717769999997,17.63823057,81,960,1019,993.6876474,155.5505371,59,257,306.6248471,258.44311519999997,99,572889,63194569,6017203
11248,1,-1202,2414,454.8417994,191036.5469,437.0772779,3616,490,1990,1066.812557,65181.49609,1500,-247,280.368396,17334.71777,880,13240388,72837698,5030812
11249,1,-2585,4272,688.5428454,449087.7344,670.1400856,6857,362,2607,1079.274177,104962.5,2245,-594,271.86020069999995,29821.09277,999,30341840,74549296,4730110
11250,1,-1777,3585,769.7665636,548545.5,740.6385757999999,5362,-68,1607,1077.140079,122633.8594,1675,-554,286.34168839999995,35510.89746,969,37922596,74254768,5247460
11251,1,-252,1040,257.6388279,38148.515380000004,195.3164493,1292,264,1578,1034.2849429999999,49960.944339999995,1314,-267,237.04380530000003,17115.59546,633,4248177,68463702,3596145
11252,1,-2969,4151,899.2466030999999,763786.5369,873.9488182,7120,-88,2196,1097.524373,194032.1875,2284,-584,298.47469010000003,49168.349369999996,1643,51753245,77091824,5701577
11253,1,-2575,3464,589.0048678999999,313705.9763,560.0946137,6039,519,1823,1035.708498,37195.05371,1304,-574,238.52738309999998,28090.8584,1009,22203311,68652294,3641300
11254,1,-959,2858,544.388935,281899.25,530.9418518,3817,19,1901,1163.1955779999998,170265.7478,1882,-455,282.9913592,25379.28491,1058,18966996,86593533,5125383
11255,1,-3878,2676,767.8772687999999,581223.1709,762.3799387,6554,-78,1852,1038.587382,216319.3594,1930,-376,300.8655223,33010.02734,1009,37736672,69034480,5793284
11256,1,-2898,5010,1173.354726,1282262.71,1132.370394,7908,-19,2274,1126.363493,187094.7188,2293,-980,367.9859245,111364.4158,1970,88112724,81196462,8666473
11257,1,0,474,229.61397630000002,9646.872803,98.21849522,474,745,1196,1018.159192,10257.53491,451,-49,191.74262530000001,4494.480225,365,3374245,66345481,2352975
11258,1,-50,454,247.96638509999997,10305.33569,101.5151993,504,823,1392,1024.288457,12397.4209,569,9,158.7312489,3471.6130369999996,307,3935189,67146678,1612519
11259,1,-939,4292,775.1183679999999,526134.3826,725.3512132999999,5231,-264,2323,1092.472275,141621.0818,2587,-465,225.8752421,21896.069340000002,831,38451743,76383723,3265256
11260,1,-929,2040,730.8752031,417598.9961,646.2190001,2969,-1441,2274,1324.202773,887944.4177,3715,-861,303.1048189,83710.53809,1484,34187428,112224831,5879842
11261,1,-2313,5050,1128.8991039999999,1168849.116,1081.133256,7363,-2186,3480,1409.279199,1060593.797,5666,-1267,410.15553450000004,152579.1162,2316,81562444,127108343,10766564
11262,1,-101,1080,449.94029119999993,58722.34741,242.32694320000002,1181,29,1441,1014.8541460000001,102680.3086,1412,-316,154.95896630000001,11753.63965,593,12956561,65915452,1536786
11263,1,-1171,5010,1158.053108,1125094.438,1060.7046890000001,6181,-1578,3009,1277.161244,783763.0615,4587,-1435,381.3497206,143225.947,2157,85829568,104393014,9307367
11264,1,-3979,2565,792.0075856000001,563764.1404,750.8422873,6544,-1107,2196,1252.502919,574442.9756,3303,-574,231.99993270000002,42448.413089999995,999,40145665,100400868,3444734
11265,1,-2020,5090,1098.912822,1121806.166,1059.153514,7110,-911,3637,1252.1508,558107.8594,4548,-1237,340.0676633,101629.6755,1949,77287001,100344424,7401345
11266,1,-4525,5121,1115.21994,1225223.765,1106.898263,9646,-490,2166,1115.397806,235500.0525,2656,-752,309.1274262,44222.1189,1365,79597793,79623185,6115825
11267,1,-1505,4575,961.5283976,867944.9099,931.6356099999999,6080,-196,2117,1143.922849,198795.9978,2313,-871,327.958553,60562.70215,1534,59170359,83747807,6883636
11268,1,-2343,5090,872.6345527000001,723246.3711,850.4389285,7433,-598,3039,1190.150903,353272.6287,3637,-1633,430.6814005,144036.0537,2989,48735428,90653387,11871134
11269,1,-2434,5111,1034.7418910000001,999601.8906,999.8009255000001,7545,-294,2225,1135.317494,220952.7461,2519,-792,304.2739309,66247.4209,1227,68524210,82492532,5925288
11270,1,-525,717,304.2717484,45241.0564,212.69945090000002,1242,421,1549,1056.059465,57063.62109,1128,-712,262.4432677,47322.55859,1642,5925203,71376742,4408094
11271,1,-636,5131,831.8992389,572123.9961,756.3887863,5767,-1274,2205,1179.337711,420119.875,3479,-851,298.35499510000005,82082.53882,1355,44291606,89013596,5697005
11272,1,-131,1969,570.9533967,181967.5313,426.5765245,2100,-1137,1774,1121.39822,349384.5303,2911,-881,359.95377310000003,122990.5225,1682,20863218,80482174,8292270
11273,1,-585,5151,868.4641796,578747.585,760.7546155,5736,-1382,2764,1236.344347,619683.0381,4146,-871,319.7160606,100269.9646,1425,48270722,97827030,6541975
11274,1,-232,5010,872.0498212000001,563071.1775,750.3806883999999,5242,-794,1950,1227.775885,596542.335,2744,-1108,343.58639289999996,116288.9216,1781,48670137,96475752,7555303
11275,1,-1020,1090,491.01118560000003,123260.6951,351.08502539999995,2110,-49,2686,1145.851594,291865.625,2735,-1277,279.1014041,74038.07813,1772,15429887,84030456,4985446
11276,1,-3060,5040,1093.744764,1069374.679,1034.105739,8100,-1794,2921,1428.856711,1216997.241,4715,-1584,475.7524796,222246.4216,2584,76561767,130664416,14485787
11277,1,-4989,5111,1173.038875,1372511.4919999999,1171.5423560000002,10100,-1392,3901,1347.352149,746331.0586,5293,-1237,390.6705973,97962.53687000001,2306,88065293,116182900,9767905
11278,1,-151,909,299.83203629999997,54166.43652,232.73683959999997,1060,225,1509,1031.530091,79463.25757,1284,-356,281.81917410000005,48966.34351,950,5753552,68099477,5083011
11279,1,-1787,3040,608.5892882999999,327964.2322,572.6816150000001,4827,254,1921,1080.8449460000002,80018.23608,1667,-544,255.5681171,40143.256839999995,1019,23704379,74766451,4180164
11280,1,-242,1171,452.04350250000005,127882.4373,357.6065397,1413,-88,1725,1082.0991390000002,176275.158,1813,-683,256.3229165,57550.7334,1148,13077973,74940067,4204892
11281,1,-5000,5202,1200.310266,1412326.15,1188.413291,10202,-1362,3254,1177.926203,508105.7732,4616,-653,310.0012097,50718.436519999996,1672,92207663,88800649,6150448
11282,1,-3939,5151,837.0097072000001,667937.2773,817.2742975,9090,-107,2911,1106.349628,95899.98438,3018,-1178,334.39142480000004,92894.18359,2564,44837456,78336608,7156328
11283,1,181,242,212.9088714,173.9375,13.18853669,61,980,1049,1011.7480539999999,185.75683590000003,69,118,150.932311,177.31933590000003,60,2901132,65512584,1457956
11284,1,60,191,127.237352,650.1630859,25.49829575,131,970,1049,1012.794718,312.10522460000004,79,168,226.42879680000004,785.5273437999999,158,1036118,65648201,3281280
11285,1,-262,515,191.7196847,16901.86621,130.00717749999998,777,323,1274,1005.881586,38029.693119999996,951,-9,148.4518546,2695.228271,276,2352412,64755057,1410429
11286,1,-474,2848,554.6352828,283957.2048,532.8763504,3322,78,1686,1063.91917,113086.1094,1608,-613,302.5519325,30706.073969999998,1098,19687699,72443136,5858411
11287,1,-2232,2767,754.1698147000001,454770.9177,674.3670497,4999,-323,1794,1084.880984,153138.9756,2117,-930,262.2303377,54078.33984,1326,36401415,75325872,4400944
11288,1,-313,1161,451.4251911,65482.06616,255.89463880000002,1474,156,1637,1017.809766,96915.15527,1481,-306,140.43843180000002,15290.3064,702,13042221,66299950,1262269
11289,1,-1050,676,325.4597229,50948.436519999996,225.71760350000002,1726,558,1686,1031.91867,29836.042719999998,1128,-396,210.7477387,17277.195069999998,1227,6779138,68150793,2842535
11290,1,-161,1212,415.6652612,76124.62866,275.9069203,1373,-68,1539,1037.106725,121214.0095,1607,-851,232.17123930000002,51367.41772,1306,11057767,68837783,3449823
11291,1,-1171,2313,543.6727962,256814.1912,506.7683802,3484,-58,2705,1121.561307,186383.6521,2763,-881,327.2958333,86449.51465,2059,18917127,80505585,6855844
11292,1,-10,606,321.44140699999997,19704.204830000002,140.3716668,616,666,1303,1004.8114640000001,22262.28296,637,-138,145.1499763,14093.656009999999,474,6612773,64617349,1348385
11293,1,101,484,306.12762860000004,5987.089844,77.37628735,383,745,1313,992.3079947000001,11554.561520000001,568,-108,121.7573791,7623.74585,365,5997704,63019210,948791
11294,1,-1212,3767,635.8217984,302717.5955,550.1977785,4979,-313,2088,1080.398147,197158.2773,2401,-1277,284.6633977,78882.60938,1910,25873239,74704650,5186128
11295,1,-1919,3868,802.6005875,607883.406,779.6687797000001,5787,-588,2039,1089.799028,214017.1951,2627,-584,403.19850110000004,94822.70215,1999,41226733,76010363,10404418
11296,1,-2393,5060,861.8869379,698854.0313,835.9748987,7453,-205,2990,1176.91769,243509.7803,3195,-1673,432.0838496,153110.1638,2712,47542342,88648656,11948573
11297,1,-1171,5000,933.7381859999999,793501.9961,890.78729,6171,-1009,2578,1094.928301,360813.5603,3587,-980,271.52396880000003,64554.21069,1593,55799488,76727551,4718417
11298,1,-3777,5141,958.5834927000001,813318.2412,901.8415832000001,8918,-1068,2588,1115.2376359999998,148690.8416,3656,-1089,265.0332821,54173.11694,1821,58808468,79600319,4495529
11299,1,111,434,290.79589060000006,7556.0,86.92525525,323,764,1127,994.6097930999999,8436.948975,363,19,111.15107959999999,2298.233398,188,5411984,63311913,790692
11300,1,-262,353,153.1711665,23394.37109,152.95218559999998,615,519,1450,984.6115033,27104.25,931,178,406.77212599999996,8647.5625,425,1501530,62045428,10589668
11301,1,-373,686,255.9829706,64653.33984,254.2702103,1059,431,1441,979.8287239,37954.25757,1010,-128,438.36120589999996,23329.44116,880,4193746,61444117,12298275
11302,1,-373,959,279.22053900000003,75496.81421,274.7668361,1332,470,1225,971.1392794,22171.381840000002,755,-59,415.08440410000003,15082.8125,742,4989703,60359136,11026884
11303,1,-181,282,84.2649282,4931.056396,70.22148102,463,852,1156,988.5150479,2376.027344,304,188,362.4665933,12270.76563,703,454437,62538368,8408450
11304,1,-949,919,262.1902935,46008.76465,214.4965376,1868,588,2529,1038.333491,50003.811519999996,1941,-1574,389.3838282,120550.1951,2851,4399600,69000732,9703665
11305,1,-2292,525,410.1469249,135583.8193,368.2170818,2817,137,2401,1027.4667570000001,63298.40234,2264,-1485,423.3230334,151203.6892,3088,10766112,67564028,11468953
11306,1,-1363,303,311.1960044,53011.60522,230.2424922,1666,549,1647,1018.126044,23381.1189,1098,-2019,469.9647427,174756.0076,3236,6197949,66341161,14135479
11307,1,-1727,303,374.5478941,79261.68652,281.534521,2030,647,1637,1017.042557,13138.99609,990,-1762,407.1355157,117476.1326,2781,8978312,66200036,10608597
11308,1,-1303,444,290.1213378,47647.59741,218.2832962,1747,705,1196,1003.9547349999999,4515.95874,491,-247,250.2606142,19327.36621,860,5386905,64507207,4008344
11309,1,-1020,4080,658.8211062,433309.4844,658.2624738,5100,-127,1705,991.2574558,198481.0938,1832,-1633,891.5828796,621994.0068,6385,27778896,62885846,50874882
11310,1,-888,747,320.3044938,101402.5615,318.43768860000006,1635,186,1460,986.0087869999999,99944.88842999999,1274,-267,424.59592919999994,48047.19897,979,6566078,62221653,11538029
11311,1,-1626,5121,1076.721376,1138516.351,1067.012817,6747,-58,2980,1125.6499509999999,206509.6631,3038,-1821,1031.365562,861931.4744,6533,74197051,81093620,68077755
11312,1,-323,1030,315.2933406,84369.16772,290.46371150000004,1353,117,1431,1020.4918470000001,93123.25562000001,1314,217,460.37661210000005,14421.93359,584,6362233,66649831,13564584
11313,1,-1474,5151,1186.041255,1398226.9840000002,1182.466483,6625,-1950,4656,1714.319107,1938452.4519999998,6606,-2693,1014.0846630000001,975647.238,7465,90028407,188088960,65815533
11314,1,-1262,4707,741.1873602999999,548520.4197,740.6216441,5969,-803,1980,1034.122885,270816.57399999996,2783,-1445,981.3986352,762551.2656,6167,35158957,68442249,61641170
11315,1,-787,3656,551.3644156,302775.5303,550.2504251,4443,98,1647,1052.882947,99416.68359,1549,-1900,652.0374079,267940.5313,4741,19456174,70948000,27209778
11316,1,-1232,4626,855.8755568,731665.5771,855.3745244999999,5858,-333,2147,1082.461785,327076.3572,2480,-1584,866.0589255000001,626373.9648,6346,46881470,74990305,48003716
11317,1,-959,1909,424.41065760000004,177361.5898,421.14319400000005,2868,-49,1774,1009.3239769999999,60630.392329999995,1823,-297,587.4703317000001,134167.7712,2821,11527962,65199033,22087769
11318,1,-1040,4131,709.8711591,450223.4834,670.9869472999999,5171,-1617,2549,1246.8190339999999,657482.3396,4166,-158,603.3502818,130289.5303,2692,32250692,99491693,23298020
11319,1,-4020,5131,1383.880504,1910048.688,1382.045111,9151,-3019,3686,1392.136981,1123539.125,6705,-2554,1209.241046,1323391.226,7405,122568016,124034904,93584890
11320,1,-313,707,299.70349930000003,47707.45215,218.4203565,1020,68,1441,947.0130015000001,124247.5615,1373,227,521.7815635,33165.561519999996,664,5748620,57397352,17424384
11321,1,-1878,5101,1186.834873,1333697.824,1154.858357,6979,-1117,2647,1212.4619710000002,640598.4688,3764,-1990,1136.71077,1060509.813,6702,90148929,94084098,82695128
11322,1,-2202,2848,761.796448,579873.5916,761.4943149000001,5050,-1901,3068,1489.426095,1444155.085,4969,-2386,912.1256766,654942.6875,6811,37141365,141976966,53246288
11323,1,-4979,5151,952.2833661000001,897175.1892,947.1933220000001,10130,-4911,4617,1373.011562,1004671.757,9528,-811,822.0250338,363348.96,5682,58037991,120650288,43246410
11324,1,-484,2404,407.5135351,158579.624,398.2205721,2888,-450,2000,1025.9201050000001,215916.0068,2450,-613,667.4538139,193898.3037,3405,10628306,67360772,28511654
11325,1,-1181,4898,1104.777466,1180483.2340000002,1086.5004529999999,6079,-1019,2480,1213.997786,597460.6094,3499,-1732,1183.9482150000001,1173607.7340000002,6524,78114128,94322600,89710936
11326,1,-3959,5171,1477.6983109999999,2165270.136,1471.48569,9130,-2392,3460,1494.170987,1392402.835,5852,-2089,1300.12661,1457025.1090000002,6910,139749907,142883004,108181069
11327,1,-313,424,150.50005190000002,21541.583740000002,146.7705139,737,578,1235,961.2514467,12158.39746,657,237,450.5490227,4955.515381,416,1449617,59136278,12991643
11328,1,-1040,4565,673.2859718999999,450481.7646,671.1793834,5605,-441,2176,1043.1858730000001,214683.6677,2617,-693,854.3764082,506569.8865,5316,29012096,69647153,46717379
11329,1,-848,4272,636.6284361,380138.8318,616.5539974999999,5120,-411,2480,1036.893173,187224.0525,2891,-772,664.7430072000001,234844.0466,3890,25938929,68809437,28280529
11330,1,-333,1595,456.6338625,159181.9099,398.9760769,1928,-921,2068,1075.65971,397477.0928,2989,-19,546.6345757,57221.74976,1523,13344927,74050804,19123799
11331,1,-212,888,320.76556370000003,48083.34741,219.27915409999997,1100,58,1568,985.1725499,166432.4138,1510,49,546.4289038,38309.20483,832,6584995,62116157,19109411
11332,1,-1626,5121,1011.501861,1017494.5970000001,1008.709372,6747,-1382,2421,1326.001225,959210.8662,3803,-1930,1024.829635,842425.2725,6751,65480705,112529872,67217650
11333,1,-4676,1696,743.0602158,544413.7224,737.8439688999999,6372,-147,3382,1117.098886,230427.9275,3529,-1118,329.01662189999996,45830.038089999995,1781,35336863,79866235,6928124
11334,1,-747,191,261.6753415,31987.01538,178.8491414,938,382,1549,1037.1743390000001,58248.614989999995,1167,49,267.4109957,4839.786865,386,4382335,68846759,4576553
11335,1,-4989,2696,757.5684478,564074.8923,751.0491944,7685,147,2490,1071.280178,79260.57813,2343,-297,317.2253487,27520.831789999997,1514,36730237,73449038,6440443
11336,1,-575,707,183.44796609999997,26903.50684,164.0228851,1282,539,1617,1026.401846,19148.18652,1078,-445,300.2351943,16522.22046,1009,2153802,67424048,5769035
11337,1,-383,585,211.19115299999999,44363.8689,210.62732230000003,968,549,1627,1020.3466480000001,45851.64063,1078,128,260.6230516,3440.1210939999996,347,2854509,66630866,4347160
11338,1,-5000,2595,875.0965572,763938.2595,874.0356168,7595,-980,4696,1213.407206,421956.2537,5676,-1881,410.92066980000004,107560.8689,3197,49010815,94230851,10806771
11339,1,-4909,1727,693.7826569,473262.4756,687.9407501000001,6636,58,4539,1127.4386279999999,245929.9685,4481,-990,320.81449080000004,39622.52246,1999,30805400,81351543,6587004
11340,1,-2252,1737,506.8454831,243903.4678,493.8658399,3989,-58,2460,1085.682058,179580.3398,2518,-1138,358.67542779999997,61015.55859,2207,16441110,75437154,8233476
11341,1,-3161,2000,527.7428795,272382.1462,521.9024298,5161,441,2284,1065.999055,72329.49976,1843,-425,289.7832973,20541.2146,979,17824803,72726655,5374359
11342,1,-262,90,127.64354660000001,3923.264648,62.63596929,352,813,1254,1016.4388349999999,5332.121094,441,138,251.34736919999997,1065.514648,198,1042744,66121466,4043232
11343,1,-393,20,154.92533480000003,7669.818115000001,87.57749777,413,774,1156,1005.469394,6307.032959,382,158,237.08144040000002,2056.86499,208,1536119,64701997,3597287
11344,1,-202,20,114.5167155,2456.741943,49.56553181,222,931,1166,1026.416498,2425.304443,235,158,233.29628430000002,907.2255858999999,148,839301,67425973,3483338
11345,1,-3777,1111,529.7592319,278310.7461,527.5516525,4888,235,2549,1079.0296859999999,75478.03027,2314,-554,276.6678119,18622.12671,1237,17961270,74515524,4898885
11346,1,-2555,2888,545.9023493,297959.4961,545.8566626,5443,-676,2696,1071.226735,198850.7188,3372,-1158,358.87284480000005,51140.413089999995,1940,19072600,73441710,8242542
11347,1,-1929,757,530.4247414,238371.9336,488.23348269999997,2686,254,2215,1028.3025910000001,105927.9023,1961,-693,356.179708,44862.29272,1405,18006426,67673998,8119295
11348,1,-282,343,144.2233511,8066.663086,89.81460397,625,833,1647,1084.8644359999998,33902.57813,814,118,271.9308851,4101.827147999999,505,1331224,75323574,4732570
11349,1,-434,50,155.6084831,6241.246094,79.00155754,484,529,1460,1000.1028460000001,17288.3689,931,-99,262.1410045,7538.975586,514,1549696,64013165,4397946
11350,1,-232,10,116.9724193,2403.443115,49.02492341,242,882,1147,1009.603364,2447.300537,265,158,244.7371358,626.8415527000001,139,875683,65235133,3833361
11351,1,-1404,1353,323.3705063,97723.50757,312.60759360000003,2757,637,1735,1036.1632960000002,36228.467769999996,1098,-475,278.35128439999994,21414.07715,940,6692383,68712600,4958684
11352,1,-1606,494,443.7688728,140687.7256,375.0836248,2100,-411,2529,1166.054546,379304.7458,2940,-891,483.50499289999993,167591.4763,2564,12603572,87019725,14961733
11353,1,-1989,626,447.3621471,157522.9001,396.8915471,2615,-196,2225,1044.761366,192585.2969,2421,-217,430.0202393,85495.43359,2048,12808505,69857684,11834714
11354,1,-3242,1363,472.92338839999996,190064.5146,435.9638915,4605,166,2578,1054.473714,55323.55371,2412,-405,270.8499065,9279.49585,810,14314018,71162548,4695019
11355,1,-2959,1565,536.1599575,275353.7461,524.7415994,4524,176,2862,1062.9074150000001,102748.2751,2686,-930,371.13064160000005,81591.16967999999,2425,18397920,72305419,8815229
11356,1,-151,0,51.84743243,757.6523437999999,27.52548535,151,1000,1049,1020.697517,116.1364746,49,178,206.7445208,223.56811519999997,59,172042,66676699,2735571
11357,1,-131,60,68.91026774,1293.389648,35.96372684,191,1000,1058,1021.2509029999999,193.31933590000003,58,138,225.4341644,868.3125,139,303912,66749018,3252516
11358,1,-343,303,199.14614609999998,25602.12109,160.00662830000002,646,745,1274,1003.9859779999999,16220.828130000002,529,118,235.3205261,3931.8398439999996,297,2538188,64511222,3544048
11359,1,-171,141,92.39901582,3387.273193,58.20028517,312,901,1127,1022.87778,1379.724365,226,138,220.3140869,570.4528809,139,546405,66961853,3106451
11360,1,-1171,262,294.10056210000005,51776.970460000004,227.5455349,1433,558,2019,1027.495081,50520.58179,1461,-79,227.45030359999998,6224.751709,524,5535689,67567753,3310953
11361,1,-363,121,157.6046279,6706.913086,81.89574522,484,735,1313,1015.237865,7038.241943000001,578,19,209.4478232,1695.917725,347,1589710,65965307,2807577
11362,1,-4202,1434,646.2626812000001,383505.5681,619.2782639,5636,450,3284,1057.930749,136640.9063,2834,-970,296.1082994,42324.436519999996,1653,26729949,71629918,5611528
11363,1,-575,40,142.3946431,8145.2771,90.25118891,615,882,1137,1015.412624,1694.0251460000002,255,49,230.6700837,2104.433594,396,1297679,65988019,3405356
11364,1,-1343,444,337.6480231,92498.13184,304.13505530000003,1787,490,1588,1040.8808390000002,36360.38257,1098,-188,244.7471591,9479.872803,712,7296396,69339707,3833675
11365,1,-1555,313,274.62340689999996,57981.63842999999,240.7937674,1868,274,1676,1037.275699,57859.875,1402,-19,224.8738883,4269.329834,424,4826753,68860216,3236369
11366,1,-1515,363,303.77451030000003,84576.14818999999,290.8197865,1878,450,1460,1002.2814289999999,58933.37109,1010,-168,265.9953301,13161.015379999999,752,5905853,64292356,4528225
11367,1,-4010,2535,690.3097922999999,459922.8708,678.1761356000001,6545,-372,3833,1149.2240789999998,280730.3181,4205,-1554,424.34353710000005,123453.1836,3544,30497767,84525823,11524316
11368,1,-353,101,157.5000992,7914.405273,88.96294326,454,568,1558,1041.345261,27840.816160000002,990,-138,256.3763103,7421.655273,682,1587602,69401597,4206644
11369,1,-2404,575,407.30089080000005,134003.8689,366.06538880000005,2979,137,2392,1035.158751,104988.1521,2255,-168,282.9074771,17778.59351,940,10617217,68579433,5122345
11370,1,-2020,505,399.2595099,143295.0273,378.5432965,2525,284,1480,981.0591295,52510.07202,1196,-257,297.9414792,19698.71484,1049,10202122,61598529,5681224
11371,1,-4898,2161,782.7047955,611394.1287,781.9169577,7059,372,3578,1068.393464,166184.9023,3206,-504,324.1708172,42727.26465,1424,39208115,73053734,6725550
11372,1,-454,-10,169.9019938,6197.621094,78.72497122,444,617,1382,1008.395453,12199.720459999999,765,99,253.21748309999998,2599.592773,267,1847468,65079129,4103622
11373,1,-1363,676,336.9330423,93669.30371000001,306.054413,2039,401,2127,1049.644084,83892.40991,1726,-1009,345.1078862,58637.25366,1702,7265528,70512173,7622365
11374,1,-292,-90,169.9610249,2011.246094,44.84691844,202,833,1107,1000.2031199999999,2342.842773,274,168,243.38469419999998,709.9157715,119,1848752,64026002,3791111
11375,1,-1595,646,334.975932,95592.05371000001,309.1796463,2241,549,1990,1035.370729,46108.43335,1441,-702,274.7523885,21243.55371,1197,7181368,68607523,4831288
11376,1,-4555,2262,827.1880171,665663.1775,815.8818404,6817,-352,2656,1124.9357,154794.8787,3008,-1079,368.8410057,72602.67188,2455,43791361,80990741,8706796
11377,1,-777,121,172.70612680000002,21466.58984,146.514811,898,421,1460,1062.522647,40779.413089999995,1039,59,236.53101669999998,5805.915771,495,1908954,72253080,3580603
11378,1,-1848,868,419.90878849999996,163338.0759,404.1510558,2716,343,1784,1006.1020470000001,86707.13842999999,1441,-346,351.0715071,67857.16772,1623,11284697,64783445,7888077
11379,1,-2606,1303,444.7918052,191100.3662,437.15027869999994,3909,401,2088,1042.384901,60460.59277,1687,-405,284.2277641,21713.638430000003,949,12661744,69540242,5170267
11380,1,-1010,1101,288.55152810000004,81095.3728,284.7724931,2111,500,1539,1058.422883,45278.83984,1039,-158,269.3958229,12372.88647,623,5328767,71696576,4644743
11381,1,-525,1171,238.8555068,55086.970460000004,234.70613640000002,1696,470,2156,1019.3772150000001,35626.84375,1686,-2316,489.480608,155970.8923,3276,3651325,66504314,15333841
11382,1,-242,141,78.16788823,2262.342773,47.56409122,383,852,1176,1013.233808,1992.6875,324,49,270.1990297,3154.67749,376,391054,65705136,4672481
11383,1,-121,131,63.80279676,3101.05835,55.68714708,252,970,1372,1050.254582,6825.6875,402,108,251.3862193,1489.366211,258,260531,70594220,4044482
11384,1,-474,1151,237.256026,54399.53101,233.2370704,1625,666,1303,1005.9093130000001,15568.8396,637,-524,277.94674060000006,20781.323969999998,1019,3602587,64758627,4944281
11385,1,-5010,2848,794.0299605,622890.0896,789.2338624,7858,-1401,4764,1200.1068380000002,403200.6052,6165,-2059,414.41964310000003,112960.1228,3167,40350949,92176411,10991593
11386,1,-979,262,200.7120138,30490.49902,174.61528859999999,1241,421,1470,1012.8568349999999,49240.90625,1049,99,282.9718129,7535.407959,495,2578260,65656254,5124675
11387,1,-2737,1181,706.7257579,456851.3064,675.9077647,3918,235,2421,1120.349499,148610.4961,2186,-1425,460.1217909,143639.9912,2543,31965523,80331712,13549572
11388,1,-494,131,129.6073397,7479.780273,86.48572295,625,921,1098,1008.3719550000001,1316.920898,177,39,251.9090238,2896.022461,416,1075076,65076096,4061322
11389,1,-2414,797,494.81012769999995,223246.4336,472.48961219999995,3211,431,1813,1037.252357,65459.13062,1382,-821,315.0216014,34651.1521,1504,15669572,68857117,6351271
11390,1,-4404,1575,813.1576953,655609.8086,809.6973562000001,5979,9,2294,1124.975701,205346.158,2285,-287,398.12135010000003,91314.34937000001,1989,42318428,80996501,10144039
11391,1,-363,343,148.8901651,15551.47559,124.70555559999998,706,754,1803,1042.761913,25744.163090000002,1049,-633,296.50613930000003,35396.14233,1207,1418770,69590554,5626617
11392,1,-1373,1656,410.49059819999997,165556.0771,406.8858281,3029,-39,3049,1086.997276,140939.9412,3088,-1821,367.7970101,86785.22437000001,2514,10784162,75620037,8657577
11393,1,-2757,1919,592.0415684,349979.8975,591.5909882999999,4676,215,3401,1104.6977949999998,190132.2188,3186,-1980,405.23226360000007,106086.9912,2989,22432846,78102862,10509644
11394,1,-1040,1050,292.8271941,74895.98608,273.6713103,2090,352,2186,1053.410488,84580.68652,1834,-841,402.18174530000005,110758.8711,1811,5487857,71019114,10352010
11395,1,-1727,2222,501.4160105,243421.7439,493.3778916,3949,147,3794,1112.085695,212906.8193,3647,-1613,448.779247,133640.2148,2484,16090753,79151014,12889780
11396,1,-3141,2282,980.8414037999999,945908.9509,972.5785063,5423,-549,3882,1207.692816,551146.6211,4431,-2089,921.6418348999999,771922.3318,6752,61571191,93345404,54363115
11397,1,-595,111,163.5005256,16841.4978,129.7747965,706,607,1598,1032.212626,24871.64746,991,-108,249.0723414,9452.808594,771,1710875,68189626,3970370
11398,1,-1797,666,378.8075658,127067.1423,356.4647841,2463,343,2401,1044.957819,99360.51465,2058,-1782,369.5474005,83593.38184,2583,9183691,69883958,8740178
11399,1,-1050,444,245.064341,52213.21484,228.50211119999997,1494,500,1519,1032.303802,33045.86108,1019,-39,260.7519175,7090.577148,514,3843618,68201673,4351460
11400,1,-1080,1323,280.0944316,71011.13257,266.479141,2403,264,2637,1070.746987,60702.54663,2373,-1306,362.2150173,85883.95313,2187,5020985,73375943,8396782
11401,1,-585,70,234.7993825,19042.62402,137.9950145,655,607,1196,991.4969269999999,17944.11621,589,-138,317.2449517,29647.09155,870,3528368,62916234,6441239
11402,1,-676,90,240.957919,21280.6709,145.87895980000002,766,392,1323,1001.995517,35892.75952,931,-59,241.86566519999997,8825.734375,593,3715886,64255681,3743936
11403,1,-797,1000,296.00762760000003,67487.56616,259.7836911,1797,352,2362,1076.727449,102558.0,2010,-118,248.11700240000002,17939.80835,741,5607713,74197888,3939971
11404,1,-1737,1595,369.7832558,116885.085,341.8846077,3332,98,2549,1071.416761,96668.15234,2451,-297,286.7007368,44123.54688,1396,8751338,73467768,5260628
11405,1,-1898,767,475.3992072,192641.1006,438.90898899999996,2665,352,3147,1106.838473,148620.3115,2795,-386,347.7524263,77342.13965,1603,14464282,78405850,7739632
11406,1,-2373,1151,594.1638688999999,320071.4353,565.7485619,3524,-274,3039,1094.6315880000002,347212.0625,3313,-950,500.91647259999996,177001.2969,2415,22593965,76685972,16058708
11407,1,-313,80,171.2111726,5040.599365,70.99717857,393,921,1078,1001.806119,1239.0898439999999,157,198,255.4301519,728.5625,128,1876049,64231392,4175652
11408,1,-303,50,161.47358530000002,5517.328125,74.27871919,353,852,1107,999.5755349,1774.527344,255,198,257.415247,862.5388184000001,148,1668718,63945680,4240807
11409,1,-383,101,151.47261509999998,7181.935303,84.74629964,484,813,1215,1009.5570349999999,4212.124022999999,402,-168,299.7856526,27901.558589999997,1267,1468413,65229146,5751772
11410,1,-373,141,135.95765659999998,6572.80835,81.07285828,514,833,1137,1011.8532970000001,1599.7148439999999,304,138,248.38138519999998,1054.25,208,1183007,65526214,3948372
11411,1,-3383,1000,682.0402412000001,406319.5818,637.4320213,4383,0,1784,1076.113711,110532.4365,1784,-138,350.500847,73024.2334,1534,29771449,74113326,7862454
11412,1,-2878,2090,596.8702487,336959.1475,580.4818235,4968,166,3598,1065.961149,173329.615,3432,-1524,395.43998439999996,95702.93359,2989,22800262,72721483,10007858
11413,1,-141,-40,96.03954264,638.4130859,25.26683767,101,950,1039,1003.9475679999999,271.1835938,89,217,269.5224654,558.4997559,139,590310,64506286,4649111
11414,1,-373,40,156.1529198,4206.419678,64.85691696,413,794,1137,1007.3260240000001,2355.319336,343,128,225.6317866,992.3688965,169,1560559,64941166,3258221
11415,1,-3646,3060,725.5613129,502713.5928,709.0229847,6706,372,2656,1126.408105,128037.7148,2284,-1653,439.9734367,140403.1475,3395,33692110,81202894,12388904
11416,1,-1888,1717,472.8778416999999,214140.6892,462.7533784,3605,225,3784,1124.161743,213434.9131,3559,-1227,362.636526,69861.6709,2078,14311261,80879336,8416336
11417,1,-4989,3434,969.6625460000001,924600.9158,961.5617067,8423,-156,4058,1127.6261359999999,270634.2478,4214,-1237,389.8578467,77092.84546,2058,60175709,81378605,9727305
11418,1,-1959,1848,513.1836751000001,249474.0173,499.4737404,3807,39,3852,1082.9706609999998,190279.8669,3813,-2762,474.84917010000004,165188.4666,3633,16854879,75060829,14430831
11419,1,-2171,1121,490.58178150000003,216192.9041,464.9654869,3292,431,2460,1032.168826,87035.12866,2029,-148,282.40421499999997,21994.53296,1058,15402911,68183839,5104137
11420,1,-1484,353,278.0524625,59100.82592999999,243.10661430000002,1837,392,2029,1057.5616630000002,63547.19702000001,1637,-227,280.4763805,17209.49121,781,4948043,71579947,5034688
11421,1,-2464,292,423.93497069999995,139124.906,372.994512,2756,382,1784,1018.547925,69983.20996000001,1402,-514,298.76239510000005,32926.913089999995,1108,11502135,66396152,5712574
11422,1,-2090,686,435.80826490000004,172554.3086,415.3965679,2776,313,1980,1054.448441,84837.6189,1667,-1465,403.9290044,109182.28300000001,2227,12155446,71159137,10442153
11423,1,-1686,1333,398.008578,148526.1189,385.3908651,3019,313,2774,1093.165051,122652.4978,2461,-1396,349.68472410000004,55117.444339999995,2108,10138293,76480629,7825882
11424,1,-1949,1949,470.9017447,219072.0076,468.05128729999996,3898,245,3245,1063.856876,131510.1833,3000,-1386,349.29006119999997,58523.16967999999,2108,14191901,72434653,7808227
11425,1,-4989,2373,829.3696119,687028.2888,828.8716962,7362,-88,3450,1177.489437,229713.9053,3538,-1099,382.99359489999995,70646.03125,1910,44022653,88734808,9387782
11426,1,-2606,474,390.0128804,129105.6892,359.31280130000005,3080,58,1764,1013.257525,73687.76465,1706,-673,302.42431899999997,30281.53809,1564,9735043,65708212,5853470
11427,1,-3121,666,522.0426976,250601.447,500.6010857,3787,176,3186,1072.516412,158368.8259,3010,-792,342.9378816,61222.40405,1782,17441829,73618653,7526809
11428,1,-1434,171,254.9142319,41086.8689,202.6989613,1605,215,1362,1027.1413,58703.350589999995,1147,69,264.74241609999996,3967.24585,406,4158801,67521232,4485667
11429,1,-343,262,130.4488645,10884.05859,104.3266917,605,549,1392,1003.1201169999999,28623.40625,843,128,265.42398280000003,2565.216553,317,1089082,64399998,4508793
11430,1,-1222,2242,429.7657611000001,181654.6736,426.20965920000003,3464,-127,2735,1078.613382,94929.28296,2862,-2019,380.51227810000006,108105.37400000001,2543,11820711,74458037,9266534
11431,1,-353,737,175.1253569,28525.48999,168.8949081,1090,882,1294,1026.048161,3206.5935059999997,412,-19,194.23391180000002,7895.045898,573,1962809,67377589,2414516
11432,1,-2555,1535,476.123917,205926.4724,453.79122120000005,4090,166,2813,1122.708152,115038.5313,2647,-1297,321.84278969999997,58240.40234,2009,14508415,80670310,6629298
11433,1,-90,20,56.05521831,563.4521484,23.73714702,110,941,1107,1018.7575310000001,715.6162109,166,-148,228.6717079,4930.109375,544,201100,66423482,3346608
11434,1,-707,414,173.53147230000002,22816.27515,151.05057150000002,1121,352,1892,1024.9664699999998,54146.78687,1540,-277,267.2500292,13845.07593,861,1927243,67235601,4571045
11435,1,-414,20,135.27506699999998,4478.402344,66.92086628,434,794,1166,1007.2981960000001,3807.928711,372,-366,296.72259249999996,10994.6814,821,1171158,64937578,5634835
11436,1,-1707,1272,430.83365769999995,163930.4763,404.8832873,2979,470,2186,1038.464416,63037.225589999995,1716,-752,334.95225869999996,35403.40991,1553,11879529,69018134,7180353
11437,1,-4757,1111,704.5404863,462192.7537,679.8475959,5868,254,3578,1070.202281,179258.9412,3324,-1039,385.80411160000006,73751.68652,1989,31768147,73301307,9526068
11438,1,-4565,272,630.8846715,348133.0381,590.0279977000001,4837,549,3725,1128.903603,176250.3398,3176,-1029,325.5157686,41182.31226,1722,25472990,81563094,6781473
11439,1,-2090,1858,404.0121633,161851.0408,402.3071473,3948,284,2480,1059.562778,85331.03125,2196,-564,270.0192412,18030.007569999998,1068,10446453,71851090,4666265
11440,1,-353,585,145.7356875,17128.87866,130.8773421,938,715,1823,1021.942406,27672.183589999997,1108,-29,223.17327909999997,4530.452147999999,444,1359289,66839442,3187604
11441,1,-808,424,190.3100677,31937.90015,178.7117795,1232,460,3245,1059.95675,99807.01465,2785,-405,291.4570884,29949.656010000002,1345,2317947,71904532,5436623
11442,1,-4141,1464,649.1366863,397517.8428,630.4901607,5605,-441,2823,1112.949228,166622.238,3264,-1722,397.7023659,111084.9529,2553,26968220,79273983,10122699
11443,1,-3585,2949,932.0244012,858660.1072,926.6391462000001,6534,-225,4764,1320.2102220000002,611723.3662,4989,-1940,567.1586804,245734.2773,3781,55594847,111549122,20586814
11444,1,-2535,939,485.13844670000003,217852.7148,466.7469495,3474,127,2333,1053.340171,116357.5564,2206,-1485,380.49193080000003,82328.78491,2494,15062996,71009633,9265543
11445,1,-4454,2686,1040.134809,1066585.689,1032.756355,7140,-1078,3450,1204.216336,336089.7185,4528,-1366,411.23024269999996,104990.5771,2791,69240347,92808767,10823060
11446,1,-2616,1101,610.1410698,352028.1709,593.3196195,3717,176,1950,1041.4543019999999,131624.0146,1774,-663,371.8709243,65193.792720000005,1861,23825416,69416132,8850431
11447,1,-1353,242,323.14683199999996,59387.07715,243.6946391,1595,431,1509,1003.6259259999999,22580.90234,1078,-79,293.1343815,11287.81812,801,6683128,64464960,5499377
11448,1,-252,-70,152.6152229,1765.014648,42.01207741,182,931,1088,997.1158957,573.798584,157,227,269.0151308,553.5153809,99,1490650,63631367,4631625
11449,1,-1161,656,333.7650043,71605.06226,267.5912223,1817,549,1970,1008.4580900000001,52295.43359,1421,-366,277.7871262,12172.55859,979,7129541,65087214,4938604
11450,1,-747,20,231.079667,15943.46777,126.26744540000001,767,401,1186,996.5813988,32805.109130000004,785,158,266.8444947,3435.2517090000006,257,3417460,63563167,4557183
11451,1,-424,-60,222.28332149999997,5989.734375,77.39337423,364,676,1186,979.3667117999998,12126.06934,510,168,253.90127880000003,922.4782715,158,3162232,61386186,4125815
11452,1,-323,212,193.3179053,15808.72559,125.73275459999999,535,500,1411,996.5306851,41595.08984,911,138,237.56268909999997,2117.902344,228,2391796,63556698,3611906
11453,1,-2969,1404,669.0826276,414353.9053,643.7032742,4373,382,2284,1065.666891,105325.7634,1902,-900,406.2728263,91167.07983,2098,28650980,72681339,10563687
11454,1,-2565,1454,512.7439053999999,251140.8428,501.1395442,4019,205,2647,1066.906151,101996.5466,2442,-1059,324.4802334,46382.614989999995,1930,16826004,72850479,6738395
11455,1,-1808,636,355.0340213,109784.9365,331.3381,2444,450,1637,1085.329659,32706.06934,1187,-851,298.89554510000005,28907.079830000002,1504,8067146,75388190,5717667
11456,1,-4717,1838,694.7479197,482017.2302,694.2746072000001,6555,274,2882,1088.462125,118209.5076,2608,-227,283.8967682,22636.8125,1246,30891179,75823987,5158232
11457,1,-4989,2131,772.1536946,592328.738,769.6289613,7120,-58,4294,1111.800152,235318.1755,4352,-1623,407.5136692,87238.05443999999,2652,38158165,79110373,10628313
11458,1,-1757,1484,445.9391775,187592.6006,433.1196146000001,3241,627,2931,1065.07835,74039.00757,2304,-2504,373.3689111,138085.7461,3028,12727152,72601081,8921878
11459,1,-393,212,105.71172479999998,9542.303711,97.68471585,605,539,1372,1011.9691050000001,9528.90625,833,-524,346.1523102,39174.296630000004,1494,715198,65541214,7668571
11460,1,-1949,2454,516.2196571000001,263905.5857,513.7174181,4403,156,2068,993.8548844000001,79955.4209,1912,-623,330.4617981,45196.0,1929,17054895,63215842,6989120
11461,1,-757,1030,280.7355016,56857.517329999995,238.44814390000002,1787,245,1990,1042.447406,82128.88965,1745,-455,297.9912174,37191.70483,1078,5043995,69548582,5683121
11462,1,-1131,222,279.1340964,39646.70313,199.1147989,1353,666,1607,1005.5084529999999,36137.85938,941,-227,239.2383095,15197.15527,722,4986614,64707024,3663038
11463,1,-2747,1595,576.5993517999999,313500.3584,559.9110272,4342,-9,4617,1156.837864,278853.9521,4626,-2267,416.3000908,127796.8767,3267,21277876,85649526,11091569
11464,1,-3818,1161,547.2738546,289095.1072,537.6756524,4979,-19,2833,1124.7243,165521.4336,2852,-524,489.09917189999993,201533.4844,2583,19168555,80960304,15309952
11465,1,-1363,434,247.0079389,44943.39819,211.9985806,1797,284,1960,1023.5173269999999,76623.82813,1676,-356,484.1162051,174282.2344,2781,3904827,67045614,14999584
11466,1,-4313,2585,715.9965193,505650.033,711.0907347,6898,352,4176,1164.73802,182642.4063,3824,-1702,349.44789039999995,92103.67943999999,2573,32809665,86823338,7815285
11467,1,-1131,1181,287.13106760000005,64888.0,254.73123089999999,2312,480,2441,1027.600261,73478.66187000001,1961,-762,327.1721164,47031.905269999996,1484,5276432,67581587,6850662
11468,1,-4979,2343,758.5165208999999,553526.4834,743.9936044,7322,98,4539,1138.5433679999999,271377.8594,4441,-2247,433.6226398,131027.0313,3048,36822228,82961984,12033830
11469,1,-1050,171,215.5805751,21506.04663,146.6494004,1221,382,1441,1024.174324,26843.64038,1059,-9,248.42003870000002,7036.923584,454,2974399,67131715,3949601
11470,1,-383,-50,210.94900890000002,4217.73999,64.94412976,333,696,1196,1020.5349699999999,9235.625,500,-49,259.89757599999996,18429.10938,761,2847967,66655464,4322992
11471,1,-626,80,295.9334543,20649.302490000002,143.6986517,706,362,1372,1017.4118970000001,65579.03809,1010,-108,279.3861016,30682.35059,1028,5604903,66248126,4995622
11472,1,-3535,1575,813.6249807999999,584536.4587,764.5498406,5110,-215,2519,1103.758543,230526.4646,2734,-198,354.3855378,81390.61693999999,1742,42367079,77970107,8037703
11473,1,-2404,1848,532.1618938,252702.3906,502.69512689999993,4252,-49,3078,1081.065338,155188.1638,3127,-712,324.06861729999997,48999.49609,1781,18124562,74796945,6721310
11474,1,-1131,585,325.2057522,101984.2148,319.34967489999997,1716,392,1715,1087.233193,72970.8396,1323,-504,297.94950289999997,29070.03809,1048,6768562,75652865,5681530
11475,1,-3222,2575,831.9191198,682402.5564,826.0766044,5797,-529,3098,1192.1338859999998,329060.2322,3627,-683,331.81908660000005,44631.89063,1673,44293723,90955725,7046650
11476,1,-4989,3030,817.2287967999999,667310.6563,816.8908472,8019,166,3941,1156.827342,198893.3975,3775,-188,284.5094188,20406.544680000003,782,42743226,85647968,5180519
11477,1,-4808,3242,1104.107926,1195893.277,1093.5690550000002,8050,-774,4754,1200.685566,482317.4041,5528,-1821,492.80902419999995,169173.9353,3533,78019476,92265333,15543087
11478,1,-1040,1959,339.64344819999997,100765.7869,317.43627210000005,2999,431,2774,1058.36843,97991.14038,2343,19,254.83260440000004,6284.871094,476,7382891,71689199,4156138
11479,1,-2858,2454,662.5085966,419304.5134,647.5372679999999,5312,-921,4274,1170.984015,292851.1211,5195,-1504,387.1536153,89133.37476,2900,28090729,87757028,9592827
11480,1,-858,1070,274.571968,63566.60132,252.1241784,1928,127,2588,1055.323114,151345.875,2461,-277,290.4474996,15993.84277,821,4824945,71277240,5399024
11481,1,-5000,3515,838.5301687000001,654595.2461,809.0706064,8515,-676,4676,1132.956565,289363.4724,5352,-1792,382.2487941,89254.2478,2831,45000502,82149797,9351305
11482,1,-1868,868,444.71105439999997,162558.9177,403.18595919999996,2736,421,1803,1050.951399,68747.38965,1382,-405,254.369011,18384.4834,1117,12657147,70687926,4141030
11483,1,-666,-50,290.94517310000003,12640.72559,112.43098140000001,616,382,1245,973.3116151,29451.746089999997,863,79,224.00129049999998,3216.33374,267,5417542,60629472,3211301
11484,1,-1909,1939,473.09778650000004,192232.0076,438.4427073,3848,264,4215,1133.916092,250936.3513,3951,-1000,304.5347373,46368.475589999995,1613,14324577,82289005,5935450
11485,1,-292,131,121.8748077,3742.991211,61.17999028,423,872,1107,1014.324876,1704.374756,235,168,231.43273190000002,754.5056152000001,129,950622,65846717,3427911
11486,1,-2262,1414,553.0287628,283481.2178,532.4295425,3676,166,3343,1104.998833,238043.1228,3177,-1039,390.4889363,84743.41382,2098,19573812,78145435,9758823
11487,1,-5000,2020,728.3316981,510347.4131,714.3860392999999,7020,49,4441,1141.673005,247339.8818,4392,-1663,363.7123047,80138.63647,2306,33949892,83418704,8466345
11488,1,-676,1212,310.2669969,87190.07007,295.2796472,1888,-127,1578,1044.9411619999998,88023.27734,1705,19,284.19994610000003,12982.60522,634,6160999,69881730,5169255
11489,1,-2666,1878,507.85007939999997,252359.1248,502.35358539999993,4544,-676,3901,1125.1701890000002,270908.1853,4577,-1287,366.05201560000006,60832.28101,2415,16506349,81024509,8575621
11490,1,-3505,1252,728.5252762,504011.7185,709.9378272000001,4757,-431,3078,1114.184736,334865.6094,3509,-297,354.1361408,48977.436519999996,1247,33967941,79450088,8026394
11491,1,-3787,1696,678.5295222,447710.8818,669.1120099,5483,-617,2950,1173.005488,302645.875,3567,-1782,411.62834039999996,107164.2478,2910,29465748,88060280,10844025
11492,1,-2101,313,497.94215589999993,194375.8416,440.88075660000004,2414,313,1745,1041.429809,65012.53882,1432,-396,294.0250574,26080.708740000002,1287,15868569,69412867,5532847
11493,1,-626,414,260.4670685,49887.09375,223.35418900000002,1040,333,1794,1045.176293,80263.16967999999,1461,-99,265.19653680000005,12376.16382,782,4341958,69913183,4501069
11494,1,-1616,1888,383.1506313,139648.3037,373.6954692,3504,235,3774,1120.267574,145729.7021,3539,-683,293.4336861,20990.642330000002,1326,9395482,80319964,5510613
11495,1,-2666,1909,531.3216275000001,272829.908,522.3312244,4575,323,2147,1087.430249,74189.08568999999,1824,-792,276.484092,24793.788819999998,1287,18067371,75680291,4892381
11496,1,-2282,2212,543.5467005,262336.0759,512.1875398,4494,245,3774,1073.1336410000001,161715.1836,3529,-1227,329.72389019999997,48063.38965,2147,18908353,73703412,6957942
11497,1,-5000,3474,1128.041368,1251907.494,1118.886721,8474,-764,4676,1196.156645,452484.2725,5440,-811,423.11973780000005,104688.8818,2424,81438549,91570606,11457940
11498,1,-3666,1656,601.8235440000001,350005.48799999995,591.6126165000001,5322,392,3235,1071.1188220000001,127195.5313,2843,-1534,365.7671305,74569.41309,2306,23180261,73426914,8562278
11499,1,-373,10,167.47942969999997,4222.542725,64.98109513,383,754,1176,997.7641254,4761.859375,422,118,277.9101417,2252.204834,258,1795159,63714128,4942979
11500,1,-838,575,278.52165539999993,51269.52734,226.42775299999997,1413,480,1833,1016.381434,51879.061519999996,1353,-1247,357.1151119,58386.85717999999,2019,4964756,66113998,8161997
11501,1,-3494,2323,611.6205292999999,357313.4685,597.7570312999999,5817,-549,3225,1139.7368119999999,261275.7773,3774,-1356,365.7878056,71222.56934,2593,23941099,83136000,8563246
11502,1,-4939,2101,1044.639658,1053557.162,1026.429326,7040,-754,3764,1244.141239,429349.8318,4518,-1504,407.78061660000003,112257.8398,2256,69841409,99064795,10642242
11503,1,-3222,1909,555.0181585,304838.7656,552.1220568,5131,-68,4088,1127.678402,238926.2732,4156,-831,292.4998397,28121.03809,1395,19714890,81386149,5475594
11504,1,-505,787,237.2025769,40175.725589999995,200.4388325,1292,529,1980,1031.978326,40740.38843,1451,-168,241.45244100000002,6158.413086,554,3600964,68158673,3731154
11505,1,-343,171,156.6892326,7271.591553,85.27362753,514,882,1352,1044.4962,10477.030270000001,470,128,232.8679548,1822.2595210000002,198,1571297,69822228,3470559
11506,1,-3646,1757,579.542101,316062.8826,562.1947017000001,5403,392,3647,1082.5215859999998,180490.5017,3255,-1237,360.4372778,65858.58496000001,2227,21495619,74998591,8314562
11507,1,-5000,2787,781.9556213,608750.5938,780.2247072,7787,-323,4431,1156.8231349999999,317097.9373,4754,-1188,342.1093118,54210.225589999995,1930,39133094,85647345,7490482
11508,1,-4989,2747,984.4631072000001,923712.0369,961.0993897,7736,-1813,4392,1284.986357,671213.6836,6205,-1891,425.8044225,117252.96,2732,62026727,105676156,11603802
11509,1,-2545,4101,832.6992723,682704.9177,826.2595946,6646,-117,4656,1198.407811,494674.9336,4773,-663,449.4677234,85452.33765,2356,44376837,91915602,12929359
11510,1,-5010,3303,1166.687592,1315631.047,1147.009611,8313,-1431,4754,1361.68724,736777.9783,6185,-2673,628.7684017999999,371782.656,3960,87114236,118668297,25302381
11511,1,-393,10,203.8901742,11311.513429999999,106.3555989,403,686,1411,1019.359542,21328.163090000002,725,158,246.2164,1717.7087399999998,198,2660557,66502008,3879841
11512,1,-3323,1737,645.2326373,380615.9678,616.9408137999999,5060,313,3333,1095.1154980000001,229945.4041,3020,-1069,376.69545889999995,73271.84277,2069,26644810,76753789,9081566
11513,1,-2151,1262,482.7188461,226669.8767,476.0985998,3413,490,2617,1080.602125,65693.08568999999,2127,-2405,465.19543939999994,169986.7478,3563,14913119,74732861,13850035
11514,1,-292,404,97.30372873,6580.632568,81.12109817,696,705,1480,1025.613681,9155.24585,775,-564,269.34164530000004,22095.55054,1068,605953,67320539,4642875
11515,1,-505,60,117.4483929,9028.811523,95.02005853,565,362,1245,1005.148318,19147.33765,883,138,255.1077591,2345.374023,238,882824,64660681,4165118
11516,1,-1252,242,238.05793019999996,40514.78491,201.282848,1494,411,1725,1043.649321,42994.569339999995,1314,-227,232.17450330000003,12835.44434,791,3626981,69709050,3449920
11517,1,-202,10,115.34926580000001,1556.9255369999998,39.45789575,212,921,1068,1014.8115740000001,822.4912109,147,178,223.66552180000002,526.9685059,99,851549,65909922,3201681
11518,1,-1777,929,359.2812269,116671.6475,341.5723166,2706,617,2431,1046.143147,46575.35522,1814,-1207,306.6747055,45235.99609,2058,8261312,70042591,6019160
11519,1,-3494,1595,512.7204861,256619.0583,506.575817,5089,-127,2696,1086.133955,129382.2568,2823,-762,304.986219,36921.631839999995,1336,16824467,75499966,5953062
11520,1,-757,939,305.5716722,93198.89818999999,305.28494589999997,1696,784,1343,1049.071003,12375.00684,559,-425,234.0959672,12358.484129999999,999,5975939,70435198,3507259
11521,1,-4989,2979,920.3715622000001,832743.75,912.5479439,7968,-549,4078,1140.13338,351106.3711,4627,-1237,416.9958783,90165.75684,2286,54213364,83193864,11128676
11522,1,-888,969,273.8969069,56108.96851,236.87331740000002,1857,215,3411,1080.140196,184497.9648,3196,-752,301.7895065,24995.77734,1415,4801249,74668982,5828922
11523,1,-4979,3030,845.0945029,683636.2334,826.8229759,8009,-686,4754,1175.6898640000002,356647.3896,5440,-1702,419.6607261,116136.0537,3058,45707822,88463786,11271368
11524,1,-1565,1101,369.8896795,126805.8711,356.09812,2666,421,1892,1029.8820699999999,60688.32788,1471,-1178,327.9865422,55769.14429,1910,8756376,67882053,6884811
11525,1,-424,272,163.4843743,12233.23804,110.60396940000001,696,470,2000,1016.033241,37473.15015,1530,-712,313.54370710000006,30253.89063,1345,1710537,66068707,6291818
11526,1,-454,252,181.5597784,14070.59155,118.6195243,706,509,1500,1029.980628,19886.26465,991,-574,295.3502423,28720.691160000002,1118,2109693,67895046,5582833
11527,1,-808,414,263.1802495,40554.77734,201.38216740000001,1222,401,2098,1012.027722,95777.52905,1697,-29,271.48946800000004,10186.780270000001,464,4432886,65548807,4717218
11528,1,-555,262,190.9230457,14984.781009999999,122.41234009999998,817,509,1343,1019.317043,24045.4353,834,29,234.30265550000001,7869.74585,436,2332903,66496463,3513455
11529,1,-1949,1606,540.8494476,274225.5625,523.6655063000001,3555,441,2470,1085.085797,112129.1719,2029,-544,278.7494675,39168.802489999995,1138,18721160,75354316,4972881
11530,1,-2949,1727,524.0974981,268000.2334,517.6873896000001,4676,-49,4049,1149.393094,242914.2927,4098,-99,308.969153,19613.33496,980,17579404,84550687,6109564
11531,1,-2959,2010,792.7124813999999,611659.2302,782.0864596,4969,-147,3254,1179.889388,336896.4063,3401,-1772,434.87776660000003,126860.6248,2831,40217157,89096894,12103595
11532,1,-2333,2080,425.86650639999993,177667.9209,421.50672699999996,4413,529,2843,1083.106376,73341.17749,2314,-722,315.4794219,38479.66577,1484,11607186,75079643,6369745
11533,1,-3000,2707,818.6571989,650367.0486,806.4533766,5707,39,4127,1143.131083,328349.4958,4088,-3237,503.7850329,214304.0076,3860,42892775,83631915,16243159
11534,1,-1717,1737,452.1020522,194530.1892,441.0557666,3454,98,2990,1062.2426970000001,161118.031,2892,-2544,463.00545020000004,170738.7537,3345,13081361,72215011,13719939
11535,1,-2000,2787,537.9001127,280108.5273,529.252801,4787,539,3205,1088.582938,126493.3506,2666,-574,274.6043461,32435.55249,1296,18517538,75840820,4826083
11536,1,-4272,1838,615.1621102000001,362544.4841,602.1166699,6110,107,2686,1068.268839,99203.95215,2579,-960,316.061777,48188.55054,1563,24219163,73036692,6393283
11537,1,-1010,1707,356.5366391,118962.0273,344.9087232,2717,294,2362,1081.436993,128021.9365,2068,-1198,533.4655858,227971.2773,2386,8135576,74848382,18213474
11538,1,-525,363,200.9465492,19131.89819,138.3181051,888,598,1441,1016.929101,13760.7146,843,-465,242.5620732,16599.68726,999,2584289,66185267,3765527
11539,1,-242,10,137.795478,1973.652344,44.42580718,252,911,1058,1013.283539,701.1523437999999,147,168,216.0682401,467.20288089999997,99,1215206,65711586,2987871
11540,1,-2919,1939,590.5271744,317470.7334,563.445413,4858,-19,2392,1062.1445509999999,158572.3455,2411,-920,301.5123857,50055.20313,1672,22318230,72201667,5818222
11541,1,-393,-30,197.66903369999997,7216.374756,84.94924812,363,754,1225,1012.638447,11072.91309,471,49,202.4249475,3273.142334,277,2500675,65627944,2622455
11542,1,-464,858,255.29039840000002,64538.77734,254.04483330000002,1322,578,1509,1052.964276,25150.357180000003,931,39,216.8049599,6433.618896,446,4171084,70958961,3008281
11543,1,-4383,3060,801.2775541,617670.7031,785.9202906,7443,-892,4764,1197.397145,412807.5564,5656,-1366,417.099752,95615.94702,2375,41090926,91760635,11134221
11544,1,-505,161,167.7322084,12234.45996,110.60949309999998,666,549,1284,1000.272877,15892.73999,735,-405,300.7005362,13241.02734,900,1800582,64034933,5786932
11545,1,-2666,2363,618.0747452,358631.2908,598.8583227999999,5029,166,2774,1116.977548,222039.5771,2608,-1297,369.7800867,75295.29688,2178,24449049,79848886,8751188
11546,1,-5000,3242,799.9930272999999,630138.2813,793.8124975,8242,-480,4647,1150.670416,316716.5381,5127,-1435,406.5201025,103366.4834,2623,40959286,84738714,10576550
11547,1,-4494,2343,1035.3267150000001,998933.8906,999.4668032,6837,-1117,3049,1185.720311,367826.3906,4166,-1574,484.89067710000006,146482.5146,3286,68601690,89979690,15047614
11548,1,-4989,2373,846.1293766000001,707792.6794,841.3041538999998,7362,-588,4480,1267.358295,538042.4998,5068,-1069,461.4087295,132534.6248,3237,45819835,102796611,13625473
11549,1,-3606,1757,582.7129305,328793.5388,573.4052135,5363,-147,3098,1112.376573,150347.3318,3245,-1871,396.60130330000004,103207.2773,2633,21731479,79192425,10066726
11550,1,-3484,2969,652.5336557,396489.6619,629.6742506,6453,-78,4696,1121.805228,300250.7031,4774,-980,330.969858,45397.57007,1831,27251211,80540606,7010627
11551,1,-1050,2535,478.20402939999997,226824.7148,476.2611834,3585,588,1970,1038.604525,29771.329830000002,1382,-811,286.5794229,41531.81226,1454,14635462,69036759,5256177
11552,1,-333,1070,193.9773666,31654.82715,177.9180349,1403,862,1107,1030.062923,1867.038086,245,59,165.0928243,2197.73999,208,2408142,67905896,1744361
11553,1,-646,1666,310.89847119999996,94206.06226,306.93006089999994,2312,607,1901,1049.351191,28845.312260000002,1294,-168,182.0907655,13987.77905,762,6186103,70472827,2122051
11554,1,-121,70,55.54066641,2208.050537,46.98989825,191,970,1058,1020.5018449999999,226.98803709999999,88,138,192.3985528,1207.554443,119,197425,66651137,2369101
11555,1,-232,-10,104.0441613,2713.933594,52.09542776,222,803,1088,1005.754925,2083.202148,285,178,272.2777477,4216.243896,475,692812,64738750,4744651
11556,1,-121,-10,60.09159675,579.1210937999999,24.06493494,111,980,1049,1011.1666529999999,210.6210938,69,257,285.15259069999996,336.1835938,59,231104,65437312,5203968
11557,1,-373,30,155.9906347,6019.376709,77.58464222,403,823,1196,1004.184697,4382.90625,373,198,255.9573023,672.2927246,108,1557317,64536762,4192905
11558,1,-444,-10,211.18112779999998,7022.069336,83.79778837,434,647,1705,1025.385972,18747.59937,1058,-118,223.5763292,3841.9648439999996,405,2854238,67290649,3199128
11559,1,-3141,1090,570.2099668,277669.8906,526.9439160000001,4231,362,2303,1016.3361199999999,98061.62866,1941,-1089,316.56190150000003,47239.538089999995,1831,20808922,66108103,6413532
11560,1,-3787,888,586.1737557,312651.1658,559.1521848,4675,-176,2039,1063.2637550000002,164855.0898,2215,-247,320.9723752,47790.921630000004,1494,21990379,72353908,6593489
11561,1,-1111,1252,354.29578039999996,106842.0273,326.8669872,2363,107,3725,1126.506464,180450.6318,3618,-356,252.31738450000003,19917.725590000002,1118,8033632,81217076,4074500
11562,1,-3808,2040,720.4502497999999,505686.6475,711.1164795,5848,-921,3549,1123.001753,279175.8086,4470,-920,439.6074598,134887.1787,3563,33219108,80712508,12368302
11563,1,-1737,151,306.2226008,63702.55371,252.3936483,1888,450,1303,1022.468742,27645.0896,853,-168,230.43281290000002,10314.94434,732,6001426,66908309,3398354
11564,1,-2676,1404,508.36705489999997,216591.2461,465.39364639999997,4080,401,1950,1094.572612,137543.2361,1549,-910,320.9991238,43961.05859,1513,16539972,76677709,6594588
11565,1,-1646,2636,507.69382069999995,255495.28100000002,505.46541030000003,4282,-166,3774,1136.5212199999999,235506.7712,3940,-1118,318.6695977,42637.9209,1721,16496193,82667551,6499220
11566,1,-1686,1070,424.2681751,142977.3064,378.123401,2756,156,3401,1103.866182,253797.5681,3245,-128,289.24049249999996,23757.5,791,11520223,77985315,5354244
11567,1,-4969,2787,753.9118296,561376.8337,749.2508482999999,7756,-862,4754,1229.372668,337520.3398,5616,-1584,337.2513668,71527.4978,2207,36376515,96726858,7279263
11568,1,-2525,1868,494.92218449999996,227598.1396,477.07246789999994,4393,539,3901,1102.4262310000001,155988.0313,3362,-1049,297.4482623,39593.02246,1969,15676670,77781990,5662430
11569,1,-434,141,206.1282974,13948.99609,118.1058682,575,617,1676,1014.8079789999999,24609.67554,1059,108,205.76253,1154.5898439999999,189,2719288,65909455,2709646
11570,1,-4898,1585,684.7873301,462980.6006,680.4267783,6483,-117,3039,1103.722126,148012.2813,3156,-524,293.2467231,27240.425539999997,1296,30011756,77964962,5503593
11571,1,-4686,2979,752.5308133,563672.8584,750.7814984,7665,-196,4725,1147.568884,327884.0938,4921,-1396,353.3278621,61611.90405,2336,36243368,84282518,7989797
11572,1,-3030,2626,707.5590632999999,468481.2517,684.4569027000001,5656,-460,4666,1206.2270460000002,385698.4336,5126,-1782,403.25660639999995,97789.95679,2960,32040949,93118956,10407417
11573,1,-181,101,99.26015376,3369.812256,58.05008403,282,823,1196,1022.299759,2942.93335,373,148,252.674321,1734.327148,218,630565,66886195,4086036
11574,1,-1656,1797,378.2468399,120264.9529,346.7923772,3453,539,2803,1062.31869,94613.33984,2264,-742,277.8592832,26425.975590000002,1375,9156523,72225344,4941170
11575,1,-2333,1373,547.6538454,264091.4275,513.8982656999999,3706,88,2960,1086.607076,235687.9219,2872,-346,325.5647017,43586.08984,1266,19195183,75565756,6783512
11576,1,-1747,444,333.39768389999995,85227.98413,291.9383225,2191,166,1980,1038.321226,92186.08984,1814,-79,262.3264605,10877.17749,831,7113857,68999102,4404171
11577,1,-3141,1707,540.8414451,269802.7461,519.4253999,4848,352,2686,1054.1824589999999,102657.0586,2334,-1168,332.5354539,50409.271239999995,2029,18720606,71123242,7077109
11578,1,-1242,1808,371.33879410000003,134815.7178,367.17259939999997,3050,392,1274,1001.9755949999999,30587.866210000004,882,-881,343.8848826,44136.75,1811,8825120,64253126,7568436
11579,1,-4868,2191,859.4969822999999,696144.4219,834.3526962999999,7059,-333,4725,1130.293974,349774.1084,5058,-2207,407.2917988,117162.9451,3296,47279044,81764126,10616743
11580,1,-3525,1606,613.7738666,358514.44700000004,598.7607594,5131,147,2735,1128.360426,169515.6836,2588,-1514,400.6141184,98995.42163,2801,24109975,81484624,10271467
11581,1,-4202,2313,787.6020966,598854.8125,773.8571007999999,6515,156,4156,1124.774401,301683.1853,4000,-1396,408.7878041,105649.96,2732,39700292,80967517,10694878
11582,1,-484,262,174.01584880000001,13797.36304,117.462177,746,490,1735,1042.749288,33591.74976,1245,108,234.7919957,3228.746094,297,1938017,69588869,3528146
11583,1,-3040,2303,661.790174,394213.3611,627.8641263,5343,-392,3156,1171.56844,315049.6052,3548,-1465,348.81408460000006,95594.06226,2554,28029839,87844647,7786961
11584,1,-5000,2838,835.6587876,674208.49,821.1019972999999,7838,-931,4617,1233.510647,364411.3025,5548,-1613,374.43864229999997,112424.78300000001,2177,44692839,97379105,8973075
11585,1,-2353,848,564.7852191000001,296874.3711,544.8617908,3201,176,2254,1244.293455,242281.5056,2078,-1633,395.4603133,115742.5193,2504,20414870,99089037,10008887
11586,1,-2646,1858,728.4394278,507614.9023,712.4709835,4504,-9,2352,1294.366164,319651.0115,2361,-1059,363.5522873,92338.83765,2029,33959936,107224561,8458897
11587,1,-2212,1666,672.1368095,437326.6111,661.3067451000001,3878,78,2401,1297.798364,366233.0898,2323,-1247,410.8533231,112594.4158,2286,28913145,107793958,10803229
11588,1,-2848,1383,472.6651993,200256.1111,447.4998448,4231,-431,2568,1137.445617,181680.4648,2999,-821,267.607893,29210.16577,1286,14298393,82802082,4583295
11589,1,-4989,3323,1140.637062,1241196.226,1114.089864,8312,-441,3333,1159.3463880000002,434295.9548,3774,-1564,429.4500662,142728.4431,3564,83267386,86021379,11803351
11590,1,-4626,3585,839.2969714,677911.4961,823.3538097999999,8211,-480,4294,1229.6242439999999,352585.2188,4774,-1742,388.5912055,116905.1943,2375,45082842,96766450,9664200
11591,1,-2939,2575,801.9032536000001,602666.6697,776.3160888,5514,-117,3794,1328.480382,453620.4287,3911,-2584,596.9894262,328819.6211,3623,41155125,112951048,22809368
11592,1,-2262,838,614.5475978,348662.4023,590.4764198,3100,49,2480,1311.87204,364875.2178,2431,-1584,389.8013116,114393.8896,2435,24170800,110144528,9724484
11593,1,-1797,1090,525.7808478999999,259161.4678,509.07903880000003,2887,117,2343,1239.067486,258352.9216,2226,-1762,422.02941619999996,143773.8962,2613,17692512,98258447,11398965
11594,1,-1777,1484,605.0730586,349944.6943,591.5612346,3261,68,2823,1284.271693,306797.0586,2755,-1534,375.2022996,108258.53300000001,2227,23431258,105558642,9009713
11595,1,-2909,3070,631.9653991,389470.6853,624.075865,5979,205,3862,1110.184268,236536.2966,3657,-1485,315.5978454,55318.05859,1980,25560337,78880583,6374528
11596,1,-4595,2242,724.6818914,501707.0068,708.3127887999999,6837,343,2921,1141.114799,136586.5818,2578,-910,305.6355315,50272.489989999995,1573,33610486,83337151,5978437
11597,1,-1727,1434,504.3598046,236880.4834,486.7036916,3161,58,2568,1158.8794289999998,219732.7568,2510,-3000,530.7681638,244682.6523,3722,16280244,85952098,18029750
11598,1,-2444,3484,732.2971455,503605.49,709.6516680999999,5928,-1343,4764,1307.143791,617089.6794,6107,-3396,632.0838305,378622.6162,4980,34320583,109351993,25569918
11599,1,-262,151,71.73192281,4853.272461,69.66543232,413,784,1215,1033.587215,5148.209961,431,9,180.0656564,2272.573975,268,329310,68371362,2075113
11600,1,-101,40,46.502856099999995,459.66381839999997,21.43977188,141,990,1058,1030.669412,155.95996090000003,68,89,138.8895132,883.439209,237,138401,67985884,1234579
11601,1,-767,2161,324.8351505,105502.6162,324.8116627,2928,607,1872,1048.4543390000001,23563.413090000002,1265,-445,191.7534631,18021.79077,1048,6753144,70352416,2353241
11602,1,-808,2979,516.324011,265897.3142,515.6523191000001,3787,254,3019,1084.976101,87008.75366,2765,-772,376.9986945,100912.6716,3009,17061791,75339081,9096193
11603,1,-535,1363,255.56313430000003,65221.96851,255.38592069999999,1898,803,1284,1017.6166400000001,5826.0625,481,-59,236.8682387,8786.717773,554,4180001,66274792,3590820
11604,1,-464,545,168.8945214,17312.53491,131.5771063,1009,784,1215,1015.493576,6292.425537,431,-485,313.7910332,37794.96484,1247,1825623,65998541,6301748
11605,1,-424,929,269.4059147,72494.27318999999,269.2476057,1353,843,1411,1028.2448259999999,6630.390381,568,-356,227.72293340000002,22952.42163,1118,4645091,67666395,3318895
11606,1,-424,1151,206.9252582,35877.08984,189.412486,1575,647,1401,1022.321768,14631.30835,754,-1633,454.2130385,152245.9685,2801,2740356,66889075,13203807
11607,1,-585,2222,415.0583167,172258.8711,415.0408065,2807,647,1892,1038.938243,26299.81812,1245,-2039,403.830971,114906.0623,2860,11025498,69081131,10437085
11608,1,-696,696,189.8922392,35717.967769999996,188.99197809999998,1392,784,1303,1032.455825,4421.183594,519,9,234.85850130000003,7736.648193000001,634,2307780,68221762,3530145
11609,1,-1282,2393,413.6041473,168214.4939,410.13960289999994,3675,676,1715,1021.6982800000001,17888.30371,1039,-188,287.3532778,33398.84375,1494,10948377,66807512,5284602
11610,1,-5000,5060,1011.3641,1004783.902,1002.3890970000001,10060,-2470,4647,1263.679715,598979.0759,7117,-1366,695.2004095,416392.4705,5989,65462870,102200731,30931431
11611,1,-727,383,197.5895367,23314.89746,152.69216569999998,1110,823,1588,1023.845661,12444.875,765,-1188,321.1463597,86522.19116,1831,2498664,67088636,6600639
11612,1,-777,747,262.53821150000005,46613.42188,215.90141699999998,1524,647,2049,1036.4885960000001,41004.59351,1402,-1871,373.2415019,118401.8662,2623,4411284,68755751,8915790
11613,1,-686,2010,346.057618,115778.9961,340.2631277,2696,558,1421,1060.60344,28605.21777,863,-39,233.4432145,9677.52124,425,7664376,71992298,3487727
11614,1,-1373,909,376.5728474,141271.6208,375.8611723,2282,98,2117,1162.961642,181958.6475,2019,-297,306.9687739,27577.111080000002,1178,9075655,86558706,6030709
11615,1,-1929,1787,607.7748478,365555.94700000004,604.6122286,3716,78,2156,1180.4528,248568.8125,2078,-594,341.3930332,61448.97632,1633,23640977,89182004,7459149
11616,1,-2010,1242,703.0820765,474133.7725,688.5737232999999,3252,0,2274,1301.949758,315365.988,2274,-801,384.4280248,99068.13965,1731,31636762,108484683,9458234
11617,1,-666,-141,344.5270082,10180.08765,100.8964204,525,490,1205,978.4375779,19105.70313,715,49,133.56927040000002,1312.4335939999999,149,7596727,61269766,1141808
11618,1,-595,-70,280.6201559,10536.92358,102.6495182,525,558,1372,989.1234281999999,22370.09375,814,-108,166.9514806,4439.884521,424,5039851,62615370,1783859
11619,1,-1020,2474,606.9763690000001,364537.4648,603.7693805,3494,666,1490,1024.796619,15505.911869999998,824,-376,304.42612510000004,42967.16968,1455,23578900,67213319,5931217
11620,1,-525,555,202.0397934,28111.038819999998,167.6634689,1080,656,1323,1021.9983869999999,20684.548580000002,667,-108,274.0581599,25015.83984,682,2612485,66846765,4806904
11621,1,-535,666,195.83491130000002,33247.99609,182.3403304,1201,343,1784,1039.967946,58622.33179,1441,-475,339.0696831,48903.186519999996,1336,2454484,69218133,7357968
11622,1,-1545,2121,455.0433358,206833.7773,454.78981669999996,3666,343,2637,1056.473334,62754.413089999995,2294,-475,367.0772015,81478.47437000001,2276,13252124,71432698,8623723
11623,1,-454,1020,249.90266859999997,61710.4834,248.41594840000002,1474,607,1950,1027.402778,27170.334960000004,1343,-257,345.4582553999999,54236.694339999995,1811,3996886,67555614,7637850
11624,1,-838,919,234.10674649999999,48905.80859,221.1465772,1757,676,1823,1004.772907,28168.78809,1147,-366,408.0071231,86698.87109,2217,3507582,64612390,10654068
11625,1,-202,0,93.13036897,1619.8903810000002,40.24786182,202,941,1068,1016.832183,484.8349609,127,148,209.99966519999998,933.3044434000001,149,555089,66172652,2822391
11626,1,-111,30,66.81621248,689.8398437999999,26.26480237,141,990,1049,1019.7931619999999,151.76464840000003,59,158,214.5395141,291.37084960000004,89,285722,66558598,2945741
11627,1,-121,40,57.01754116,1276.3085939999999,35.72546142,161,980,1049,1016.1538390000001,185.6210938,69,188,222.34337889999998,353.56030269999997,79,208064,66084392,3163941
11628,1,-1303,424,208.88644490000001,38338.71069,195.8027341,1727,470,1441,1030.866679,18297.919680000003,971,-594,333.265988,77542.89746000001,2584,2792547,68011911,7108238
11629,1,-2343,1161,468.63328550000006,199656.7646,446.8296819,3504,392,1598,1080.18726,69842.85522,1206,-643,269.3776972,36843.34375,1405,14055498,74675489,4644118
11630,1,-2272,1979,586.9069746,310987.9509,557.6629367,4251,352,2725,1076.857305,148591.4063,2373,-990,370.110161,91931.46875,1742,22045427,74215786,8766818
11631,1,-1939,727,407.29856980000005,128304.6094,358.196328,2666,343,1490,1026.86565,44490.874019999996,1147,-435,210.0358972,17754.511469999998,939,10617096,67484996,2823365
11632,1,-2424,797,466.71734289999995,176164.4412,419.7194791,3221,245,2254,1073.6448289999998,105288.9023,2009,-910,305.88210039999996,57505.40991,1642,13940805,73773646,5988087
11633,1,-858,535,300.9221245,81157.24609,284.88110869999997,1393,470,1784,1085.5301630000001,58912.54467999999,1314,-851,268.8545146,33596.77734,1286,5795464,75416047,4626096
11634,1,-3868,4333,952.0808051000001,899874.0583,948.6169187,8201,-1088,4735,1241.133353,619531.8594,5823,-1000,448.6413517,131120.2969,2742,58013303,98586368,12881860
11635,1,-2040,767,405.246607,140325.585,374.6005672,2807,352,1392,1027.726374,56033.99121,1040,-663,274.55859460000005,42173.05444,1276,10510388,67598176,4824475
11636,1,-393,-131,233.6327246,3140.339844,56.03873521,262,745,1127,1001.057925,5426.725586,382,108,169.98786719999998,1027.7460939999999,139,3493392,64135486,1849336
11637,1,-2979,909,542.3179562000001,262973.0603,512.8089901000001,3888,117,1872,1066.006383,151716.5212,1755,-514,249.72647540000003,26547.75,1068,18822961,72727655,3991252
11638,1,-3070,3121,707.2601073,479691.8201,692.5978776000001,6191,-2235,4794,1196.9292679999999,507646.5544,7029,-1227,339.15734269999996,64522.16382,1791,32013879,91688939,7361773
11639,1,-5000,4040,884.1734663999999,754589.2568,868.6709716,9040,-1117,4686,1170.698743,332779.49,5803,-801,254.1562634,32733.15625,1365,50032814,87714275,4134106
11640,1,-535,242,278.89256439999997,21300.569340000002,145.9471457,777,617,1441,1014.5852679999999,25473.200930000003,824,-49,173.0034772,4144.868896,395,4977988,65880529,1915533
11641,1,-2818,2262,618.4175622,324434.5693,569.5915812000001,5080,-254,3441,1112.715288,225847.7969,3695,-811,244.5311202,38186.46875,1405,24476178,79240660,3826910
11642,1,-797,656,283.70032599999996,77666.92871000001,278.68786969999996,1453,39,2019,1064.88971,138672.1006,1980,89,271.3448567,11798.10059,742,5151096,72575366,4712194
11643,1,-1333,1262,469.4163098,217784.033,466.67336860000006,2595,39,2245,1235.74163,231159.7344,2206,-415,322.8670392,48502.86621,1286,14102507,97731672,6671560
11644,1,-2050,777,576.7278522999999,322885.0427,568.2297447000001,2827,-176,2500,1281.8960630000001,340484.9568,2676,-990,352.454607,79240.49121000001,1772,21287361,105168481,7950352
11645,1,-1010,10,364.5355778,30426.178710000004,174.4310142,1020,186,1558,1012.04875,71575.16967999999,1372,-108,159.3528906,12765.20313,513,8504716,65551531,1625174
11646,1,-4989,2323,924.7690421,784873.3711,885.9307936,7312,-941,2637,1236.024512,409780.7881,3578,-1445,505.07545849999997,231414.085,4544,54732658,97776422,16326478
11647,1,-2696,2141,574.8642231000001,295861.249,543.9312907000001,4837,-147,2294,1041.805067,187571.9373,2441,-1287,355.6123021,91333.15015,2504,21150008,69462899,8093447
11648,1,-4565,3111,744.7692176,530762.6318,728.5345783,7676,-1647,4725,1196.581348,364621.0759,6372,-1108,282.9364438,48535.686519999996,1533,35499596,91635643,5123394
11649,1,-1111,2000,395.31251480000003,154242.7634,392.7375249,3111,666,1450,1081.919648,26185.0625,784,-504,281.9888351,31110.82788,1137,10001407,74915208,5089133
11650,1,-4979,2868,760.4797622000001,574792.9365,758.1509985,7847,-245,3490,1135.193548,192357.2322,3735,-287,252.3345374,15875.828130000002,841,37013086,82474521,4075054
11651,1,-3898,3535,855.2393214,673646.6443,820.7597969,7433,-68,2852,1201.259118,181262.7021,2920,-1069,346.91589849999997,97977.02515,2267,46811795,92353502,7702441
11652,1,-3686,3484,759.3347313999999,541707.8357,736.0080405,7170,205,3598,1145.104253,222371.5,3393,-1287,348.7941728,98248.375,2564,36901711,83920880,7786072
11653,1,-515,50,251.34833270000001,14906.52124,122.0922653,565,460,1333,992.3656631000001,41250.57397,873,-19,155.35388030000001,5472.706787,335,4043263,63026535,1544629
11654,1,-878,828,357.3665835,72294.77246000001,268.8768723,1706,88,2813,1134.700642,192743.0017,2725,-277,163.28890230000002,10355.17749,603,8173496,82402915,1706449
11655,1,-575,30,293.76396239999997,16063.98413,126.7437735,605,549,1598,1002.0523699999999,38464.939210000004,1049,-386,147.74116940000002,7446.197020999999,663,5523025,64262973,1396957
11656,1,-383,10,197.27855469999997,6220.017334,78.86708651,393,647,1245,1031.230257,8064.871094,598,99,187.0224335,1345.2692869999998,188,2490805,68059894,2238553
11657,1,-838,1181,272.3370212,70452.16967999999,265.428276,2019,656,1362,1051.5037220000002,24482.53687,706,-49,213.6786796,10940.407959999999,415,4746717,70762245,2922149
11658,1,-2909,2959,678.8176071,446378.3398,668.1155137999999,5868,-676,4529,1238.054409,415926.0586,5205,-3178,533.7479215,247190.1943,3841,29490774,98097838,18232758
11659,1,-1868,1202,572.8475201,320666.624,566.2743364,3070,29,2254,1223.831369,225026.6943,2225,-1079,344.7911506,77709.99121000001,1979,21001874,95856846,7608380
11660,1,-2050,757,537.1514568,267678.5225,517.376577,2807,117,2176,1229.686679,243162.28100000002,2059,-1534,391.29718169999995,111796.5701,2395,18466028,96776277,9799263
11661,1,-373,1151,232.99802169999998,52664.239989999995,229.48690589999998,1524,784,1196,1027.836069,6750.685303,412,-257,261.5382381,12396.06934,752,3474437,67612607,4377744
11662,1,-474,797,187.447576,32186.746089999997,179.40665009999998,1271,823,1127,1006.981349,2981.1875,304,138,269.8347585,3139.544678,267,2248742,64896732,4659891
11663,1,-202,242,75.88200132,5521.206787,74.30482344,444,774,1078,1011.3065029999999,1693.749023,304,168,266.2722115,1312.099365,198,368517,65455414,4537657
11664,1,-414,50,161.8019623,9571.109375,97.83204677,464,656,1676,1052.9780759999999,29598.954830000002,1020,-277,260.2325282,18325.90625,663,1675512,70960821,4334142
11665,1,-2595,2151,559.2997296,275143.8037,524.5415176,4746,176,2872,1023.438918,140647.1563,2696,-1009,309.7719423,55494.819339999995,2236,20020236,67035342,6141354
11666,1,-4181,3282,780.0558774,575652.5994,758.7177337,7463,68,3215,1122.970426,215779.988,3147,-495,234.42679429999998,20909.90601,1049,38943179,80708005,3517179
11667,1,-1949,1444,461.69856239999996,198143.9961,445.1336834,3393,411,2431,1085.3407300000001,90702.1084,2020,-1118,312.16394429999997,59342.06812,1791,13642596,75389728,6236565
11668,1,-1525,717,478.71306969999995,213057.0408,461.5810230000001,2242,127,2127,1206.741105,192777.8428,2000,-2415,529.6635725,256837.12399999998,3157,14666637,93198342,17954784
11669,1,-3474,1555,694.8336019,461836.6482,679.5856445000001,5029,98,3990,1280.6384460000002,398446.9451,3892,-2306,457.549929,167262.8506,3246,30898799,104962229,13398524
11670,1,-666,1181,304.3492546,92627.99609,304.3484781,1847,490,1284,1038.6284150000001,22511.038819999998,794,39,218.37052799999998,4278.569336,396,5928222,69039935,3051884
11671,1,-1666,919,481.1169784,206336.4353,454.2427053,2585,117,2519,1210.252434,231257.7693,2402,-1425,380.12138280000005,114492.9431,2167,14814307,93741501,9247505
11672,1,-2040,2161,642.1116166,396592.3552,629.7557901,4201,-9,2264,1296.9091859999999,307510.2969,2273,-1059,359.3359327,93554.70996000001,2078,26387669,107646300,8263828
11673,1,-1565,565,338.4681253,79375.1189,281.7359027,2130,401,2039,1046.318061,62684.22827000001,1638,-910,269.5931541,49118.21875,1454,7331883,70066015,4651550
11674,1,-4969,2707,782.8863363,586071.3611,765.5529773,7676,68,4166,1107.414112,238920.115,4098,-2425,378.648068,120341.5544,2959,39226305,78487425,9175959
11675,1,-5000,3929,872.8190498,710652.3086,843.0019624,8929,-509,4519,1151.4620869999999,346507.2969,5028,-1306,363.5366213,97945.43652,3048,48756038,84855356,8458168
11676,1,-2888,2020,697.5627324,430654.1248,656.2424283,4908,-529,4058,1219.128666,450300.6111,4587,-267,215.2677838,22614.59277,831,31142001,95121581,2965774
11677,1,-2464,1464,555.6820696000001,297691.8398,545.6114367,3928,637,1823,1089.130882,46749.90405,1186,-821,246.75364109999998,32416.070069999998,1335,19762084,75917189,3896791
11678,1,-1494,1242,460.3555182,196547.3279,443.3365853,2736,166,2166,1195.843942,199711.1619,2000,-762,304.6712624,57674.18726,1643,13563341,91522735,5940773
11679,1,-1575,1444,475.1500914,209041.8455,457.210942,3019,166,1872,1147.935341,138189.8533,1706,-1148,313.5803326,61684.30859,1821,14449127,84336355,6293288
11680,1,-1797,1272,385.3609307,107351.1208,327.644809,3069,441,1970,1037.593377,46597.03491,1529,-475,210.2782011,16061.130619999998,791,9504195,68902401,2829883
11681,1,-474,323,174.7806661,16990.58984,130.3479568,797,568,1431,1032.350927,31459.4375,863,-19,205.797572,7471.241943000001,454,1955090,68207900,2710569
11682,1,-727,1242,283.3445065,74030.75952,272.08594139999997,1969,950,1303,1075.048742,7182.208740000001,353,-99,195.136851,4549.347412,366,5138183,73966707,2437017
11683,1,-1262,2191,433.3327784,182518.78100000002,427.2221682,3453,215,1803,1138.142634,127077.8906,1588,-1089,337.3229165,76598.03809,1584,12017747,82903594,7282352
11684,1,-414,-40,267.961751,4105.964844,64.07780305,374,666,1480,1031.4015570000001,17356.075930000003,814,49,178.99214369999999,1740.433594,248,4595424,68082507,2050444
11685,1,-2929,1606,613.5467712999999,303531.2029,550.9366596,4535,9,2392,1036.056926,167615.6326,2383,-1207,345.801989,88498.42749,2375,24092137,68698493,7653057
11686,1,-3292,1747,572.1830591,281443.5115,530.5124989,5039,-78,2745,1118.976129,180462.0681,2823,-1247,311.0867293,71449.2146,1860,20953181,80134885,6193597
11687,1,-4131,3494,912.5580375,800345.2947,894.6201957999999,7625,-1127,4803,1222.348297,478417.8298,5930,-1792,480.1935645,161408.6404,3940,53296779,95624663,14757495
11688,1,-2252,1060,498.2276086,224331.5225,473.63648770000003,3312,9,2127,1060.886562,124886.4587,2118,-940,298.9040398,48716.18359,1484,15886768,72030739,5717992
11689,1,-353,10,213.8868349,5766.325928,75.93632812,363,794,1303,1024.868444,10624.595459999999,509,49,173.646327,1385.7067869999998,208,2927845,67222741,1929795
11690,1,-818,-30,278.8925925,16160.77319,127.1250298,788,333,1421,1004.630584,40688.32983,1088,39,164.7591519,2087.67749,218,4977989,64594087,1737317
11691,1,-2292,767,497.0009903,189926.322,435.8053717,3059,215,2529,1064.42254,128740.8281,2314,-564,233.890065,24395.92871,1078,15808639,72511702,3501092
11692,1,-1262,565,343.29249100000004,85376.56812000001,292.19268999999997,1827,421,1725,1067.5408949999999,62588.77734,1304,-69,197.0783474,5908.967772999999,465,7542383,72937188,2485752
11693,1,-404,141,205.72155790000002,16092.54468,126.8563939,545,872,1519,1073.111517,21566.10913,647,19,216.3881423,3592.322021,268,2708567,73700373,2996725
11694,1,-1838,2232,580.9043998999999,318924.1599,564.7337071000001,4070,392,1470,1112.67057,60844.70288,1078,-891,368.5181898,79888.18652,1584,21596795,79234291,8691562
11695,1,-545,606,209.5717732,36107.42554,190.01953989999998,1151,392,1784,992.2192534,28656.751710000004,1392,-762,538.3481535,165463.324,2811,2810901,63007939,18548399
11696,1,-3535,2363,632.5035573,385465.0898,620.8583493,5898,186,3656,1135.6750539999998,165793.4236,3470,-1326,341.81201430000004,63957.01342999999,2088,25603888,82544501,7477469
11697,1,-1727,626,448.1007316000001,181771.822,426.3470676,2353,117,2029,1172.10985,144584.2334,1912,-683,322.2941688,57782.80859,1405,12850833,87925856,6647906
11698,1,-1434,1010,491.0618278,232387.7773,482.0661545,2444,-98,2215,1175.4733820000001,240479.4587,2313,-1396,392.3946116,101460.9443,2207,15433070,88431211,9854306
11699,1,-3363,535,515.5155338000001,217993.5291,466.8977715,3898,-441,1607,1113.966323,174993.7773,2048,-435,235.7657405,22376.11694,890,17008401,79418942,3557471
11700,1,-252,1131,237.6609981,52398.74121,228.90771329999998,1383,137,1745,1057.366555,92994.33984,1608,-237,301.09837989999994,15609.91968,870,3614896,71553538,5802255
11701,1,-4838,2282,968.7835236,897516.2791,947.3733578,7120,-774,4490,1346.345592,466792.6912,5264,-2950,603.0068796,329131.6462,3821,60066657,116009373,23271507
11702,1,-2292,1000,686.3534986000001,434456.7344,659.1333206,3292,-49,2294,1291.9209230000001,305820.9939,2343,-1574,408.8444272,128166.0291,2722,30149192,106819819,10697841
11703,1,-1535,1888,497.78058980000003,195108.0935,441.7104182,3423,-147,3823,1119.137642,251906.4834,3970,-1079,277.182025,39869.8125,1623,15858273,80158020,4917112
11704,1,-545,262,177.14515590000002,20289.68359,142.4418604,807,382,1686,1047.006387,70939.55859,1304,59,242.58580959999998,4427.733397999999,376,2008346,70158232,3766264
11705,1,-747,1626,288.2501355,79855.1521,282.58653910000004,2373,941,1450,1095.080362,15048.96484,509,-257,256.44809419999996,19715.14746,672,5317641,76748864,4209000
11706,1,-1525,1949,592.4846385,323185.5662,568.4941215,3474,29,1843,1184.0432779999999,151580.2556,1814,-653,299.1257835,47841.10718,1375,22466435,89725343,5726479
11707,1,-111,151,60.136173600000006,2769.003662,52.62132326,262,980,1078,1022.875061,287.78881839999997,98,69,194.31341469999998,1246.8532710000002,188,231447,66961497,2416493
11708,1,-232,10,117.119597,1842.811523,42.92798066,242,990,1313,1058.442879,6320.029053,323,118,228.69155669999998,2535.978271,278,877888,71699285,3347189
11709,1,-777,3020,512.7601321999999,262361.115,512.2119825,3797,627,1441,1058.4406199999999,32088.986080000002,814,-633,267.2838496,30130.09375,1137,16827069,71698979,4572202
11710,1,-1393,2505,550.5373795,280909.0273,530.0085163,3898,137,1872,1167.2044529999998,167478.1287,1735,-881,286.7127537,51792.11304,1603,19397850,87191439,5261069
11711,1,-1121,797,271.9314309,72069.37671,268.457402,1918,68,2137,1096.126319,157200.5225,2069,-49,287.3645333,20639.60938,821,4732589,76895546,5285016
11712,1,-696,-30,281.9109733,14393.00366,119.97084509999999,666,431,1490,1057.943384,41508.24585,1059,-89,153.1967179,4934.9646,376,5086323,71631629,1502031
11713,1,-4717,1828,717.7538423,458756.906,677.3159573,6545,-549,3921,1067.4659980000001,220222.1709,4470,-1722,365.3959539,103590.6091,2484,32970917,72926954,8544909
11714,1,-989,80,423.676782,70962.65405,266.3881643,1069,107,1715,1062.014492,172551.8037,1608,-198,193.08543280000004,15686.76343,643,11488129,72183986,2386047
11715,1,-4242,1303,750.5838769,468589.1406,684.5357117000001,5545,-656,2127,1062.23479,190350.5,2783,-237,228.58915109999998,18143.52734,840,36056074,72213936,3344192
11716,1,-2343,989,546.8912998,227550.5615,477.02260060000003,3332,88,2509,1073.026859,185066.9216,2421,-633,228.59649900000002,16671.073969999998,1128,19141766,73688745,3344407
11717,1,-292,-151,227.4342625,974.7021483999999,31.22022019,141,921,1068,1002.445323,829.9990234,147,108,180.4599592,776.0212402000001,129,3310486,64313384,2084211
11718,1,-3070,404,598.8874712,280973.3513,530.0691948,3474,441,3460,1093.01208,156696.4961,3019,-1782,334.9015014,80346.94897,2405,22954637,76459226,7178177
11719,1,-292,-10,198.0766108,2394.339844,48.93199203,282,862,1098,1010.564106,2086.467773,236,29,203.63777580000001,2573.108398,317,2510998,65359348,2653974
11720,1,-2181,828,477.8533052,186203.3896,431.5129079,3009,-176,2911,1112.531144,197676.1423,3087,-861,302.7870797,51084.06226,1712,14614002,79214435,5867521
11721,1,-1757,1111,461.3120216,171256.5068,413.8314957,2868,343,1656,1038.110385,74577.02905,1313,-564,287.0734608,21779.80444,1187,13619762,68971083,5274315
11722,1,-878,808,273.69494310000005,70981.15796,266.4228931,1686,558,1500,1016.140108,31040.15625,942,-9,237.8215586,8007.725586,424,4794171,66082606,3619782
11723,1,-838,70,243.32806430000002,26904.101319999998,164.0246973,908,-137,1617,1046.470556,79792.48438,1754,-188,232.1911591,9976.644287000001,633,3789347,70086440,3450415
11724,1,-313,-70,203.4519676,1959.4313960000002,44.26546505,243,950,1303,1024.775372,4338.756836,353,148,218.3553941,1043.325928,149,2649133,67210532,3051461
11725,1,-4030,2060,708.5614717999999,475668.3416,689.6871331,6090,264,3176,1003.6241279999999,181349.6306,2912,-138,230.8891441,12726.4353,781,32131799,64464729,3411827
11726,1,-1525,1030,423.91611789999996,140352.2344,374.63613599999996,2555,843,2215,1096.580117,41852.064210000004,1372,-574,276.58709639999995,35601.67944,1108,11501112,76959229,4896027
11727,1,-1686,414,381.63478530000003,105288.0662,324.48122620000004,2100,666,1450,1016.6585970000001,25296.30835,784,-247,225.23390619999998,11810.4209,672,9321287,66150061,3246740
11728,1,-454,121,241.11518250000003,11101.76563,105.3649165,575,666,1627,1009.399172,25002.30859,961,-148,216.1587958,7656.631836,613,3720738,65208748,2990376
11729,1,-1838,606,424.19836160000006,132311.1875,363.7460481,2444,362,1666,1023.2889220000001,72642.75684,1304,-732,282.16653439999993,46488.265380000004,1514,11516432,67015694,5095549
11730,1,-818,808,294.48320730000006,62767.96069,250.5353482,1626,607,1578,1056.11525,39913.20093,971,-336,232.66227540000003,14424.945069999998,712,5550103,71384283,3464431
11731,1,-2252,707,514.0846234,249822.9375,499.82290610000007,2959,294,1960,1150.710032,120210.3044,1666,-1059,320.6064809,54312.861079999995,1870,16914112,84744549,6578465
11732,1,-1070,616,298.58538880000003,84092.24585,289.9866305,1686,-9,2078,1124.5959,202463.6318,2087,-59,313.4560127,14742.70288,692,5705807,80941820,6288299
11733,1,-1777,2191,624.0819633,370455.8533,608.6508468,3968,19,2078,1193.0349099999999,248513.4099,2059,-1990,448.6070803,144351.1553,2890,24926611,91093267,12879892
11734,1,-484,111,254.49118969999998,11585.08179,107.63401780000001,595,490,2029,1019.2783289999999,41988.467769999996,1539,0,175.94721330000002,1967.038818,257,4145009,66491412,1981275
11735,1,-262,-111,194.2991009,725.9626465,26.943694,151,931,1058,1006.668368,307.49975589999997,127,138,196.9704531,497.64624019999997,99,2416137,64856397,2483031
11736,1,-1424,1181,383.8181536,104764.4209,323.6733244,2605,313,2647,1048.689204,106456.5115,2334,-1207,285.8794272,45632.984130000004,1840,9428248,70383939,5230531
11737,1,-2474,2464,588.4753737999999,321126.5017,566.6802464,4938,49,2705,1101.0702390000001,153804.0583,2656,-2910,577.6965845,303782.7148,4593,22163409,77590763,21358934
11738,1,-424,282,172.5359564,12029.74609,109.6801992,706,696,1754,1031.641873,25318.833740000002,1058,-732,303.4787369,63432.62109,1464,1905194,68114237,5894358
11739,1,-434,474,185.26505509999998,15916.282959999999,126.1597517,908,460,1784,1066.46305,33202.20215,1324,-1524,393.5181857,98657.93359,2494,2196681,72789980,9910820
11740,1,-959,929,292.85864760000004,70405.68359,265.34069339999996,1888,549,1529,1046.0264619999998,44923.251710000004,980,-712,256.4263113,27136.062260000002,1266,5489036,70026967,4208285
11741,1,-5000,3161,1032.5919529999999,1015035.865,1007.489883,8161,-313,4254,1189.678548,461996.3943,4567,-1475,443.31098,156249.1523,3138,68239753,90581443,12577576
11742,1,-424,10,272.3621498,5053.228271,71.08606243,434,519,1205,997.0108215,18287.91187,686,-69,196.6321915,5823.983397999999,385,4747593,63617957,2474510
11743,1,-3010,2080,554.6098291000001,253346.7412,503.3356149,5090,-656,3029,1127.639217,219118.6287,3685,-1772,390.2049341,119538.4724,3108,19685892,81380493,9744633
11744,1,-666,60,265.9277686,19549.72437,139.82032890000002,726,333,1343,1010.870989,37610.14746,1010,89,197.2434251,3572.717773,237,4525925,65399050,2489918
11745,1,-292,-151,218.25909199999998,1304.46875,36.11743,141,941,1107,1004.285054,823.453125,166,138,189.9445232,787.7770996,129,3048770,64549662,2309051
11746,1,-353,-70,229.00504909999998,3284.108398,57.3071409,283,901,1519,1042.093214,12176.58569,618,99,172.90848369999998,933.5585937999999,138,3356372,69501329,1913430
11747,1,-2040,767,483.6905971,179273.6943,423.40724410000007,2807,294,2441,1049.1634470000001,116865.9287,2147,-1336,334.1622454,70961.34375,2326,14973222,70447612,7146522
11748,1,-878,1181,292.2990763,60008.46777,244.96625840000002,2059,637,2392,1040.769742,60448.68359,1755,-910,293.8945921,43589.694339999995,1345,5468080,69324906,5527938
11749,1,-1414,868,430.9268717,156914.7256,396.1246339,2282,294,1725,1113.49532,115642.365,1431,-633,284.9305837,38116.217769999996,1246,11884670,79351797,5195868
11750,1,-2535,1474,579.210454,318282.7881,564.165568,4009,98,2490,1220.386017,255298.7656,2392,-1405,407.5747439,122036.8572,2236,21471024,95317890,10631499
11751,1,-2070,878,620.562522,353879.3711,594.8776102,2948,19,3941,1298.92559,423339.8896,3922,-1920,440.04509709999996,144369.5615,2771,24646262,107981292,12392940
11752,1,-2383,1232,539.7711899,215555.9648,464.28005,3615,823,1676,1062.111642,26663.68726,853,-1297,285.73654819999996,61631.96777,2118,18646588,72197193,5225304
11753,1,-272,-10,202.4975694,2374.591553,48.72978096,262,921,1362,1033.446093,5404.204834,441,29,174.915024,1059.62085,208,2624337,68352693,1958097
11754,1,-1454,1161,393.0961834,136295.3904,369.18205589999997,2615,235,4578,1115.197873,290937.7908,4343,-376,253.9947096,13409.05859,979,9889575,79594643,4128852
11755,1,-737,545,231.1103971,38933.157960000004,197.31487009999998,1282,352,1862,1111.559061,64670.47827000001,1510,-306,281.65950739999994,22412.5564,949,3418369,79076067,5077253
11756,1,-4585,4202,895.9030796,773800.7361,879.6594432,8787,-1362,4794,1238.8953689999998,543997.0251,6156,-2475,529.5631749,243151.96,3524,51369109,98231151,17947978
11757,1,-686,545,251.4750547,26860.101319999998,163.89051630000003,1231,431,1598,1012.580822,28224.0603,1167,-1762,437.72390700000005,137415.1084,2999,4047341,65620475,12262542
11758,1,-707,505,251.2697442,54920.761470000005,234.35179,1212,666,1784,1127.8103720000001,46334.25952,1118,-396,228.71273599999998,13764.782959999999,752,4040735,81405199,3347809
11759,1,-1414,878,436.3356828,168248.3181,410.1808359,2292,264,2088,1127.169103,129151.8193,1824,-1504,366.0512046,93749.36304,2286,12184885,81312652,8575583
11760,1,-1666,1303,619.8684336,359381.3818,599.4842632,2969,49,2156,1214.10226,243296.738,2107,-1227,381.29618569999997,98609.20215,2207,24591160,94338835,9304754
11761,1,-575,252,310.0591425,24203.75562,155.5755624,827,509,2284,1013.78706,73509.9646,1775,-118,178.361422,4695.970459,474,6152747,65776909,2036019
11762,1,-313,-171,241.0351699,1297.657959,36.02301985,142,852,1088,998.6460991,1851.327148,236,108,171.865727,886.9763184000001,149,3718269,63826818,1890421
11763,1,-323,-121,218.42085950000003,1811.304443,42.5594225,202,931,1078,1006.0814529999999,1075.372803,147,99,172.9117821,876.1677245999999,148,3053291,64780793,1913503
11764,1,-555,-121,222.5496082,4868.751709,69.77644093,434,529,1215,1007.8015519999999,10031.05859,686,108,186.3169343,800.4755859,149,3169813,65002494,2221696
11765,1,-535,-10,201.55640490000002,8061.654053,89.78671423,525,490,1500,1039.658613,25069.56152,1010,39,208.4404516,1595.2126460000002,267,2599999,69176962,2780635
11766,1,-616,1070,259.25723230000006,57726.33496,240.2630537,1686,637,1254,1006.2286640000001,16180.22559,617,-297,251.9598182,12365.36621,752,4301716,64799752,4062960
11767,1,-4000,2454,678.2411306,428360.3975,654.4924732000001,6454,-9,3558,1125.2586720000002,197277.2537,3567,-2316,441.9218858,159319.533,3088,29440706,81037253,12498877
11768,1,-1888,2707,579.464691,309590.9861,556.4090097,4595,254,2107,1067.3773199999998,108879.0225,1853,-2257,441.6191091,132277.1875,3257,21489877,72914838,12481756
11769,1,-1282,484,311.61790510000003,68776.62109,262.2529716,1766,588,2088,1068.6436640000002,45790.28125,1500,-821,266.0232896,28493.175539999997,1484,6214766,73087954,4529177
11770,1,-1252,1424,372.55471489999996,116943.8611,341.97055589999997,2676,617,1892,1102.579596,58880.6853,1275,-1247,379.0185723,104729.0212,2128,8883009,77803633,9193925
11771,1,-4767,1868,787.4919246000001,581555.8398,762.5980854,6635,156,2960,1123.843517,179082.9844,2804,-1514,371.0348914,96831.32202,2216,39689186,80833552,8810681
11772,1,-2929,2535,645.5388616,390481.4841,624.8851768,5464,166,3000,1155.942047,215482.0427,2834,-1069,375.825321,93686.60327,1861,26670107,85516929,9039659
11773,1,-696,3868,767.7261068,525536.6084,724.9390377000001,4564,58,1882,1020.930749,153934.4365,1824,-1673,613.0585591,243719.90600000002,3445,37721816,66707174,24053811
11774,1,-1222,939,321.54621560000004,102852.8584,320.7068107,2161,735,1872,1065.120071,37191.78101,1137,-366,283.6728419,35221.01465,1019,6617086,72606769,5150098
11775,1,-50,181,82.06656978,2680.814209,51.77657973,231,911,1147,1020.5240150000001,1865.988037,236,-138,238.557645,6915.584961,494,431035,66654033,3642224
11776,1,-707,585,240.61584399999998,52440.7771,228.9995133,1292,764,1823,1014.808172,20438.65234,1059,-277,283.965722,21572.34277,831,3705343,65909480,5160738
11777,1,-242,505,143.1470507,16652.888430000003,129.04607099999998,747,852,1225,1005.07914,5021.181396,373,-217,291.869486,16142.02319,741,1311429,64651781,5452019
11778,1,-515,434,191.6349068,34965.18359,186.98979540000002,949,882,1441,1025.790495,10028.47241,559,-396,279.29828369999996,32345.183589999997,871,2350332,67343753,4992482
11779,1,-525,363,128.60841729999999,15581.06152,124.82412240000002,888,823,1147,1018.223016,2012.335693,324,-237,264.9016917,17057.06152,890,1058568,66353799,4491066
11780,1,-454,333,124.988937,14179.42163,119.0773767,787,931,1333,1023.892092,3966.825928,402,-455,262.1438954,19414.607180000003,930,999823,67094721,4398043
11781,1,-363,343,143.5915975,19840.65991,140.8568774,706,862,1362,1013.2009300000001,5844.777344,500,-643,292.0294024,30737.02905,1197,1319587,65700872,5457995
11782,1,-363,353,114.26435910000001,13053.05859,114.24998290000002,716,911,1078,1020.52439,815.015625,167,-19,231.51744669999997,4655.679443,365,835606,66654082,3430421
11783,1,-888,363,199.0779135,39400.880619999996,198.4965506,1251,872,1352,1017.6865619999999,6095.214844,480,-158,236.5450538,11392.99121,563,2536449,66283900,3581028
11784,1,-1000,353,182.59569409999997,33025.01465,181.72785880000004,1353,843,1392,1024.57675,5433.197021,549,-89,234.85653870000002,6399.433594,455,2133836,67184481,3530086
11785,1,-80,40,25.61737691,507.7148438,22.53252857,120,990,1058,1023.0573210000001,181.21777340000003,68,138,203.4136795,875.5625,139,42000,66985362,2648136
11786,1,-50,20,17.63341997,277.5146484,16.65877092,70,1000,1039,1022.658476,100.4255371,39,188,215.0025799,195.74780269999997,69,19900,66933143,2958471
11787,1,-272,272,70.30702756,4832.499756,69.51618341,544,941,1049,1020.549921,325.11303710000004,108,39,209.9135983,890.6708983999999,238,316357,66657417,2820078
11788,1,-272,505,155.49145880000003,23370.67871,152.8747157,777,911,1156,1011.71136,1186.109375,245,9,256.99674730000004,7354.695068000001,416,1547366,65507832,4227029
11789,1,-363,282,128.37852959999998,16476.329830000002,128.3601567,645,921,1117,1012.1563070000001,1043.636475,196,19,263.3113651,11882.77734,733,1054787,65565465,4437304
11790,1,-151,242,79.52770744,6239.09375,78.98793421,393,941,1117,1020.432583,755.1523437999999,176,89,213.99361119999998,2340.560303,336,404778,66642090,2930769
11791,1,-292,515,125.1803699,15668.40234,125.17348899999999,807,705,1274,1024.130477,7773.751709,569,-415,224.2351932,11478.577879999999,870,1002888,67125967,3218011
11792,1,-565,545,199.7871915,39902.1189,199.75514740000003,1110,784,1333,1030.551142,13011.6084,549,-267,318.07190130000004,30455.29077,1039,2554555,67970282,6474863
11793,1,-313,575,162.6835022,26165.65796,161.75802290000001,888,735,1333,1011.8315460000001,8652.372803,598,-89,270.6305138,15655.87402,861,1693819,65523397,4687416
11794,1,-616,555,171.9349441,29116.678710000004,170.6361003,1171,813,1421,1024.586128,5899.45874,608,-376,296.0160996,21961.46875,1108,1891944,67185711,5608034
11795,1,-434,555,167.896499,27466.128660000002,165.7290821,989,823,1147,1018.5313880000001,2163.530273,324,-108,248.9930659,10942.732179999999,702,1804111,66393996,3967843
11796,1,-222,161,60.54053394,3648.397461,60.4019657,383,911,1058,1020.921176,508.970459,147,9,193.64162290000002,1663.77124,268,234570,66705923,2399813
11797,1,-272,212,77.71884424,5831.777344,76.36607456,484,960,1088,1022.882477,654.4960937999999,128,89,231.6422349,4678.902344,277,386574,66962468,3434120
11798,1,-545,505,223.85667850000002,49377.74121,222.2110286,1050,794,1392,1024.199955,15935.64429,598,-237,278.5709907,30925.544680000003,741,3207156,67135075,4966515
11799,1,-363,464,114.82391409999998,12207.96875,110.4896771,827,960,1058,1017.860256,606.0585937999999,98,-29,250.4716488,4481.698975,385,843810,66306528,4015107
11800,1,-424,535,133.6075176,17259.87109,131.37682859999998,959,960,1088,1024.152249,599.8083496,128,59,190.47485890000002,3298.706787,277,1142462,67128821,2321963
11801,1,-90,-20,53.64815933,187.109375,13.67879289,70,1009,1039,1026.247594,123.33984380000001,30,118,158.36251919999998,164.03808590000003,70,184200,67403784,1605036
11802,1,-80,-30,47.77878713,100.1708984,10.00854127,50,1000,1058,1026.590412,121.46777340000001,58,128,160.5593738,169.31152340000003,60,146100,67448824,1649876
11803,1,-80,-30,57.43202504,116.77246090000001,10.80613071,50,1009,1049,1024.0366199999999,75.0,40,148,180.8573765,213.6950684,59,211100,67113664,2093401
11804,1,-60,-10,41.06016926,172.24121090000003,13.12406991,50,1009,1039,1023.406872,65.234375,30,158,188.7074041,131.2302246,59,107900,67031144,2279071
11805,1,-50,0,25.52572232,80.05371094,8.947273939,50,1009,1049,1024.984329,95.99609375,40,138,183.87202580000002,188.2614746,69,41700,67237944,2163771
11806,1,-50,0,28.85849095,135.52246090000003,11.64141147,50,1000,1058,1025.796246,158.98339840000003,58,138,165.79335780000002,252.12402340000003,60,53300,67344508,1759196
11807,1,-212,444,149.8640008,20644.99121,143.6836498,656,941,1303,1026.330942,2121.52124,362,-19,171.9846923,4481.243896,355,1437390,67414733,1893039
11808,1,0,70,35.53167601,185.8398438,13.63230882,70,1000,1039,1017.1272119999999,99.85327148,39,178,215.5306315,275.47241210000004,69,80800,66211057,2973021
11809,1,-515,2888,530.3272722,265018.6443,514.7996157,3403,578,1401,1019.576076,17540.74609,823,-316,400.1639898,88875.58984,2286,17999809,66530264,10248398
11810,1,-797,2484,548.566712,286472.8896,535.2316224,3281,147,1970,1056.888387,124934.8115,1823,-415,439.1757905,118175.6523,1999,19259228,71488836,12344024
11811,1,-969,2393,693.5185199,444115.9365,666.4202402000001,3362,88,1921,1042.210909,103224.2791,1833,-455,490.2879893,153615.2461,2108,30781948,69517029,15384468
11812,1,-646,2202,439.3944518999999,184942.1521,430.0490113,2848,294,2000,1040.6763429999999,65178.484379999994,1706,-564,395.06734,82119.70092999999,2049,12356319,69312464,9989005
11813,1,-383,2646,625.7029672,317885.2517,563.8131355,3029,-127,1882,1046.081154,161190.1553,2009,-405,452.6690465,121740.11300000001,1860,25056269,70034290,13114193
11814,1,-454,2313,437.3540114,163753.6475,404.66485819999997,2767,245,2196,1026.5668210000001,69403.40234,1951,-415,353.89478039999995,56392.67554,1573,12241826,67445724,8015457
11815,1,-181,1656,454.6564122,136694.3318,369.72196549999995,1837,245,1980,1016.994907,91650.03491,1735,-554,377.4054517,56402.65234,1454,13229597,66193833,9115832
11816,1,-353,2292,465.63900989999996,180267.0273,424.57864680000006,2645,362,1323,980.2762605,55737.96265,961,-1207,415.1749255,89713.96875,2523,13876460,61500259,11031694
11817,1,-595,2131,440.91738530000003,156230.6443,395.2602235,2726,166,1352,1011.184964,43508.46484,1186,-89,359.5019341,46414.599369999996,1277,12442121,65439682,8271465
11818,1,-373,1585,342.5458683,86630.58568999999,294.330742,1958,539,1431,998.6346538999999,19860.886469999998,892,-79,306.869781,20914.256840000002,900,7509611,63825355,6026820
11819,1,-202,1606,377.82701069999996,102690.7256,320.4539368,1808,529,1509,1009.235075,37093.71484,980,-207,340.4958012,40492.751710000004,1226,9136208,65187548,7419993
11820,1,30,979,301.73658839999996,33174.65234,182.13910159999998,949,323,1225,979.7159823999999,28859.64063,902,148,286.01324819999996,3219.720459,317,5826878,61429978,5235429
11821,1,-353,2151,405.84907139999996,107457.9521,327.8077976,2504,39,1343,1002.8212390000001,60744.93359,1304,-118,305.0026895,18659.646240000002,1108,10541662,64361628,5953705
11822,1,-434,1343,357.432074,87607.54688,295.9857207,1777,607,1186,975.6727807,14368.7959,579,-79,315.38862439999997,13648.45093,821,8176492,60923992,6366079
11823,1,-363,2333,379.6234565,125181.9287,353.81058310000003,2696,225,1431,1019.027125,49386.03125,1206,-89,340.5957327,39007.87476,1386,9223294,66458642,7424349
11824,1,-515,1646,460.1808408,172028.4756,414.763156,2161,598,1372,991.2403846000001,26134.62402,774,-158,357.00735289999994,47294.48438,1177,13553050,62883680,8157072
11825,1,-282,1626,328.7144705,84495.74976,290.68152630000003,1908,656,1274,995.2863046,13060.95874,618,-118,308.71209280000005,17549.319340000002,860,6915405,63398069,6099402
11826,1,-30,646,274.9510752,31379.88965,177.1436977,676,558,1313,988.7636772,21627.99194,755,79,274.74672999999996,6899.066162,425,4838278,62569831,4831089
11827,1,131,282,205.8015959,770.1657715,27.75186069,151,931,1058,993.4569065,535.2148438,127,178,243.33252709999996,480.2255859,119,2710675,63165224,3789486
11828,1,171,222,195.4416873,141.9782715,11.91546354,51,970,1019,994.4813818,87.27734375,49,207,240.7376684,144.4335938,70,2444637,63295566,3709096
11829,1,181,222,195.12207719999998,96.359375,9.816281119,41,970,1019,996.7328896,121.626709,49,207,234.0531457,156.42089840000003,60,2436648,63582493,3505976
11830,1,181,232,203.9482931,119.03808590000001,10.91045764,51,980,1019,996.8763166000001,96.07983398,39,198,225.3788824,163.60913090000003,49,2662074,63600793,3250921
11831,1,181,232,202.80759819999997,130.99975590000003,11.44551248,51,970,1009,995.8978047,107.66308590000001,39,198,228.07794040000002,128.1306152,49,2632379,63475996,3329251
11832,1,161,212,193.5183696,97.75756836,9.887242707999999,51,970,1019,997.1695411000001,88.828125,49,217,235.5968485,148.60839840000003,50,2396759,63638214,3552376
11833,1,141,191,171.1169191,146.7773438,12.11516998,50,980,1019,995.7984548000001,96.5,39,227,249.1314914,127.734375,50,1873984,63463332,3972256
11834,1,70,333,198.8943658,1850.183594,43.01376052,263,892,1068,991.5697624,572.0771484,176,198,256.5759512,423.15625,108,2531774,62925478,4213198
11835,1,171,222,199.2509802,118.6071777,10.89069225,51,970,1009,990.6211986999999,85.33764648,39,217,246.5251001,150.95214840000003,60,2540861,62805143,3889576
11836,1,70,383,187.35957240000002,1700.335693,41.23512694,313,872,1137,1008.6049,1408.834961,265,178,228.6058631,212.49584959999999,79,2246631,65106166,3344681
11837,1,-90,1606,339.28578480000004,75351.99121000001,274.5031716,1696,725,1333,987.955773,19664.294680000003,608,-396,318.1672614,36157.58496,1425,7367350,62467623,6478746
11838,1,-545,1929,295.9880435,73272.60132,270.689123,2474,529,1333,1001.225827,16590.33496,804,-544,368.59553969999996,69966.17749,2573,5606971,64157002,8695211
11839,1,-555,2686,438.54127869999996,165448.072,406.7530848,3241,401,2509,1029.7339539999998,71787.88257,2108,-267,309.79791800000004,32517.991210000004,1544,12308381,67862529,6142384
11840,1,-30,707,240.54927379999998,23702.517330000002,153.9562189,737,627,1343,997.2933527,13503.78125,716,118,261.6787749,3163.589844,317,3703293,63654018,4382450
11841,1,161,222,194.7351166,158.345459,12.58353921,61,970,1009,990.6052758,84.74609375,39,227,249.3834898,175.56152340000003,60,2426993,62803124,3980296
11842,1,171,222,195.6981493,120.2692871,10.96673548,51,980,1019,995.2216148,67.90234375,39,207,231.3174226,117.87109380000001,50,2451057,63389828,3424496
11843,1,171,222,196.4872372,111.5681152,10.5625809,51,980,1019,998.5354587999999,70.8125,39,207,225.0380523,101.4648438,40,2470863,63812676,3241096
11844,1,161,222,197.88269880000001,126.62109380000001,11.25260387,61,980,1019,997.7501017999999,93.73999023,39,198,223.194527,107.7009277,49,2506084,63712337,3188211
11845,1,-151,1131,302.66829,59935.21777,244.81670240000003,1282,725,1392,1002.261178,11016.90625,667,-366,285.728455,18042.21484,950,5862918,64289758,5225008
11846,1,-575,1909,378.3270122,114427.5564,338.2714242,2484,294,1450,989.5226832000001,48141.22241,1156,-59,352.1137955,38920.756839999995,1395,9160405,62665929,7934984
11847,1,-666,2484,544.9740533,263335.9365,513.1626804,3150,294,1705,1011.527148,44849.81616,1411,-435,418.1707,87537.24976,2058,19007790,65483979,11191471
11848,1,-1020,3121,472.5121361000001,206456.9756,454.37536860000006,4141,558,1862,1029.992225,31007.861080000002,1304,-1257,388.7811483,81173.99902,2989,14289134,67896575,9673650
11849,1,-696,2424,523.0133991,233836.2263,483.5661551,3120,450,1941,1003.9593570000001,36816.52905,1491,-762,413.83649019999996,93236.43921,2049,17506753,64507801,10960681
11850,1,10,303,185.1731875,6028.347412,77.64243306,293,950,1078,999.8811961000001,637.2148437999999,128,168,255.7161207,946.1520995999999,148,2194503,63984794,4185007
11851,1,-727,2464,454.98895930000003,165060.3923,406.2762513,3191,382,1813,1008.41304,44608.41968,1431,-455,340.8033937,50922.58179,1732,13248957,65081399,7433405
11852,1,-898,2060,417.1460139,163028.4119,403.7677697,2958,421,1441,1024.834331,23673.1709,1020,-227,328.5609723,41146.217769999996,1355,11136691,67218266,6908948
11853,1,-777,2737,653.7488886,378705.32399999996,615.3903834,3514,235,1627,998.7248197999999,70954.77905,1392,-603,445.182266,111162.25,2236,27352807,63836881,12683984
11854,1,-616,3010,584.5256891,315588.0313,561.7722236000001,3626,382,1735,1025.630347,38403.50757,1353,-1148,544.5598422999999,204404.7166,3633,21866898,67322727,18978907
11855,1,-989,4878,713.5999404,481948.2881,694.224955,5867,88,2715,1057.4832,125632.1211,2627,-702,444.1239797,131333.5701,3206,32590392,71569326,12623751
11856,1,-464,1787,316.9994085,88662.0625,297.7617546,2251,529,1480,1019.302933,16731.08984,951,-752,276.71824,26025.298580000002,1405,6431272,66494622,4900671
11857,1,-303,1929,363.10675510000004,100952.9607,317.7309565,2232,558,1303,994.4410412000001,17548.7439,745,-287,307.41751939999995,34296.64063,1267,8438177,63290431,6048354
11858,1,-434,1838,389.9215666,131145.0291,362.139516,2272,509,1637,1009.690183,27862.84937,1128,-247,329.9110676,34175.75,1276,9730485,65246353,6965844
11859,1,-494,2656,462.4300454,191186.5935,437.2488919,3150,588,1490,982.3694172,28297.9021,902,-980,376.22877850000003,77016.21777,2088,13685859,61763179,9059078
11860,1,-323,959,269.2316904,45358.583739999995,212.97554730000002,1282,696,1343,999.1936436000001,8860.375,647,-99,286.2778098,13286.419679999999,821,4639085,63896828,5245119
11861,1,-171,1434,269.8561538,61764.506839999995,248.52466040000002,1605,637,1372,1007.0074480000001,15875.67871,735,-19,310.56958760000003,20415.40625,1068,4660630,64900096,6173022
11862,1,-434,2090,540.8265376,264864.6709,514.650047,2524,401,1294,978.8047319,38887.10132,893,-396,421.8862221,73244.73022,1623,18719574,61315757,11391231
11863,1,-373,1878,335.1752107,105330.9763,324.54734060000004,2251,656,1813,1022.5653550000001,29953.871089999997,1157,-663,355.7644059,40077.17871,1613,7189915,66920954,8100372
11864,1,-333,2070,517.891594,231221.5955,480.855067,2403,166,1921,1020.1692029999999,96659.69897,1755,-396,423.40819550000003,78864.73438,1702,17165549,66607693,11473568
11865,1,-191,777,232.81125,40690.64819,201.7192311,968,294,1490,1009.407577,40782.65625,1196,-118,313.6515284,22494.24902,811,3468869,65209834,6296146
11866,1,40,131,90.02282697,439.65405269999997,20.96792915,91,990,1098,1016.23544,478.46875,108,168,233.8582971,524.4138184,99,518663,66095006,3500141
11867,1,-262,1272,335.3601842,75776.2478,275.2748586,1534,598,1235,998.4414417000002,22099.33984,637,-693,324.9289345,29351.053710000004,1405,7197853,63800660,6757044
11868,1,-383,1929,363.3866097,109554.5154,330.9902044,2312,676,1500,1012.875085,27727.616210000004,824,-514,351.8013022,63017.31152,1870,8451189,65658620,7920906
11869,1,-212,1404,281.64186589999997,67661.51538,260.1182719,1616,627,1568,1013.765729,24061.361080000002,941,-178,315.95349239999996,25868.107180000003,1098,5076617,65774141,6388903
11870,1,-282,1747,472.2432669,173221.9646,416.1994289,2029,264,1333,992.7427285,64837.90527,1069,-158,438.1411195,95508.8689,1633,14272877,63074440,12285929
11871,1,-454,1656,442.67311229999996,155073.3806,393.79357610000005,2110,313,1558,993.8140388,56803.18359,1245,-168,408.8887188,73238.15601,1425,12541407,63210646,10700159
11872,1,-353,1404,392.8096907,124978.2419,353.5226187,1757,539,1421,981.1269987,35000.42188,882,-168,375.9696838,50309.57007,1168,9875165,61607052,9046605
11873,1,0,404,202.97725400000002,6049.374756,77.77772661,404,764,1156,988.8340751000001,4764.712646,392,118,275.6677121,5369.625,436,2636785,62578741,4863532
11874,1,30,303,201.7715679,3805.7536619999996,61.69079074,273,705,1117,978.1518926000001,7069.967773,412,188,299.9216043,8674.522461,475,2605553,61233992,5756990
11875,1,-878,525,225.8022849,48119.40405,219.36135499999997,1403,833,1539,1038.417418,13834.913819999998,706,-990,353.342831,74647.15234,1742,3263147,69011887,7990474
11876,1,-1787,515,312.6446415,97224.12085,311.80782680000004,2302,803,1539,1010.1505070000001,7456.154053,736,-405,279.52518330000004,15062.7146,880,6255787,65305859,5000597
11877,1,-535,313,145.04605949999998,20492.698969999998,143.1527121,848,921,1166,1014.62135,1609.017334,245,-356,247.17507080000001,12688.640379999999,771,1346455,65885215,3910113
11878,1,-626,323,144.9168404,19536.632569999998,139.7735045,949,882,1343,1019.717953,5758.159912,461,-584,295.5834537,27673.345460000004,1098,1344057,66548781,5591653
11879,1,-464,363,118.3926861,12585.86108,112.18672420000001,827,862,1245,1017.747544,3109.514648,383,-326,263.1972882,13251.83984,741,897077,66291844,4433460
11880,1,-262,2131,328.01164710000006,102750.5251,320.5472276,2393,637,1382,1005.577967,12030.6189,745,-19,292.7937361,20806.72437,1098,6885865,64715971,5486603
11881,1,-444,1707,323.2722585,98616.78882,314.0331015,2151,558,1578,1038.890521,31261.445069999998,1020,-861,339.78115660000003,56516.08569,1960,6688317,69074785,7388879
11882,1,-646,2444,595.7674541,318140.8298,564.0397414,3090,156,2392,997.7274568,82987.36693999999,2236,-821,511.7872483,140604.5898,2662,22716087,63709445,16763276
11883,1,-656,2535,538.4179806,276390.7556,525.7287852,3191,186,1558,1024.881685,90166.20996000001,1372,-386,454.2082225,112084.8884,1989,18553211,67224478,13203527
11884,1,-404,2737,638.688341,373934.4177,611.5017725,3141,372,2294,1055.096138,108064.9626,1922,-524,547.0516001,166484.9255,2533,26107059,71246583,19152989
11885,1,-535,2242,420.3687369,144646.4961,380.32419869999995,2777,401,1647,1002.229483,52985.62109,1246,-1000,420.4584551,100747.25,2920,11309432,64285692,11314260
11886,1,-828,727,314.1925415,97006.35522,311.45843260000004,1555,725,1470,1013.419683,16334.814209999999,745,-584,354.2480593,57680.27246,1296,6317885,65729245,8031468
11887,1,-767,858,247.4657489,60283.13452000001,245.52624,1625,627,1754,1020.600558,22219.756840000002,1127,-59,269.2562964,14320.005619999998,583,3919315,66664032,4639933
11888,1,-494,2050,484.21623200000005,229252.0681,478.8027445,2544,470,1460,1021.3570480000001,29939.241210000004,990,-722,399.2746744,78950.53296,1731,15005783,66762894,10202897
11889,1,-303,1747,331.83057610000003,81391.87402,285.29261119999995,2050,431,1333,1001.7935560000001,15461.13843,902,-514,312.30473900000004,35393.1084,1355,7047138,64229781,6242192
11890,1,141,212,174.1402093,287.5898438,16.9584741,71,960,1029,1002.905848,155.892334,69,178,210.49276260000002,161.2536621,59,1940788,64372489,2835661
11891,1,141,242,182.94560330000002,219.85058590000003,14.82735937,101,980,1039,1003.222215,132.35058590000003,59,178,205.724558,143.703125,49,2142022,64413108,2708646
11892,1,-262,989,276.6396856,47176.189210000004,217.20080389999998,1251,549,1254,970.7044961000001,21926.788090000002,705,-79,319.8394373,23765.96069,880,4897889,60305102,6547025
11893,1,-353,2242,528.5274059,222934.9688,472.1598973999999,2595,352,1519,1023.5422560000001,40124.6875,1167,-346,380.1190808,54911.896239999995,1662,17877838,67048880,9247393
11894,1,-717,1313,399.47921180000003,144756.7732,380.46914879999997,2030,470,1862,1085.793834,66648.44434,1392,-1297,444.2667941000001,103497.7693,2188,10213353,75452688,12631871
11895,1,-616,363,146.0220981,19351.92554,139.1111985,979,833,1519,1020.486342,8437.756836,686,-148,269.7873294,8973.706787000001,613,1364637,66649112,4658253
11896,1,-444,3090,540.965673,274296.3103,523.7330525,3534,9,1549,1048.912443,69928.87402,1540,-168,435.10603949999995,82949.55835,1890,18729207,70413908,12116305
11897,1,-525,2242,543.8358409,232748.5779,482.4402324,2767,-176,1578,994.8742304,84987.34937000001,1754,-158,463.92168319999996,98227.26342999999,1979,18928475,63345583,13774293
11898,1,212,252,231.8086495,56.15234375,7.493486755,40,960,990,972.6951925000001,75.75683594,30,277,300.40111210000003,81.38256836,39,3439056,60552700,5775413
11899,1,-232,626,292.8536324,43545.842769999996,208.67640680000002,858,490,2333,1029.172476,66152.59351,1843,-841,343.6088347,96144.52734,2029,5488848,67788543,7556290
11900,1,-101,505,251.35821669999999,17190.8103,131.1137304,606,686,1460,1005.634051,16106.55371,774,-475,350.3371813,71469.27515,1534,4043581,64723190,7855113
11901,1,40,363,191.6367413,3685.898193,60.71159851,323,921,1078,1010.9832470000001,1040.030273,157,29,173.9531187,2589.444336,297,2350377,65413576,1936620
11902,1,-505,858,250.8661869,41999.37109,204.93748090000003,1363,666,1431,1049.395689,17485.24902,765,-445,155.6876882,8885.897461,751,4027766,70478804,1551274
11903,1,-1000,1090,415.8009966,169446.2461,411.6384896,2090,411,2696,1077.292331,92662.58179,2285,-2475,591.8520982999999,319991.1523,3930,11064990,74275761,22418490
11904,1,-121,272,88.25610815,4423.327881,66.50810387,393,862,1137,1033.527289,2186.936523,275,-39,138.9567716,1756.874756,256,498505,68363434,1235775
11905,1,-393,686,238.58066639999998,36529.786869999996,191.1276716,1079,578,1931,1046.865433,43475.65991,1353,-811,343.5359561,102176.3708,2068,3642927,70139343,7553085
11906,1,-484,868,329.5842552,86786.4834,294.59545719999994,1352,588,1764,1074.823488,38657.05859,1176,-1049,235.5666042,35006.85938,1633,6952050,73935714,3551464
11907,1,-111,1696,338.15441180000005,71602.84375,267.5870769,1807,156,2137,1033.526502,75351.61621000001,1981,-356,282.08836160000004,62067.24609,1425,7318298,68363330,5092726
11908,1,-1151,3000,709.7358443,447021.4531,668.5966296,4151,88,2147,1126.7572109999999,180428.6719,2059,-762,339.75682939999996,85240.21068999999,1870,32238398,81253236,7387821
11909,1,-565,2171,413.8603705,153963.4912,392.38181810000003,2736,362,1598,1051.40256,33510.663089999995,1236,-148,284.2501099,42626.73438,1296,10961946,70748630,5171080
11910,1,-131,545,255.9868161,26867.85938,163.914183,676,529,1568,1038.462611,32898.34375,1039,-287,260.62991600000004,43008.37085,1009,4193872,69017894,4347389
11911,1,-616,3090,675.765041,379104.8435,615.7149044,3706,215,2696,1070.553084,135305.0156,2481,-584,267.15175930000004,49944.42188,1336,29226137,73349370,4567684
11912,1,-656,2565,516.0941048000001,237336.1318,487.171563,3221,58,1607,1034.823128,129534.4834,1549,-415,278.39966769999995,54240.59277,1474,17046600,68534970,4960408
11913,1,-626,3323,590.3530326,280924.8279,530.023422,3949,294,2264,1072.552322,62421.70092999999,1970,-346,296.43412,47245.74609,1464,22305069,73623583,5623884
11914,1,-484,5080,676.9707573,426471.7656,653.0480577000001,5564,568,4411,1148.174074,196458.6423,3843,-39,217.69466859999997,19072.38965,999,29330522,84371437,3033022
11915,1,-808,1484,316.9706956,86096.65991,293.4223235,2292,323,1970,1026.272115,64608.177489999995,1647,-920,225.58379130000003,26155.570069999998,1325,6430107,67407005,3256835
11916,1,-60,313,174.8658861,2568.917725,50.68449195,373,882,1215,1015.6949900000001,2045.589844,333,-485,204.5380084,17670.1228,851,1956997,66024724,2677491
11917,1,40,202,134.1061264,1007.17749,31.73605978,162,990,1058,1018.890167,190.09936519999997,68,69,171.238047,645.1630859,158,1151005,66440779,1876638
11918,1,111,151,129.9172814,83.95996094,9.16296682,40,1000,1039,1020.806827,84.11694336,39,128,155.39043569999998,111.49902340000001,50,1080224,66690981,1545356
11919,1,-242,444,160.8755827,11477.202879999999,107.1317081,686,843,1352,1024.821593,4848.904053,509,-1178,317.8350594,68292.05371000001,1811,1656381,67216595,6465224
11920,1,-787,1353,278.7281662,73294.11499,270.7288588,2140,490,1862,1057.607035,26736.22241,1372,-2386,406.3976078,145833.6716,3386,4972121,71586089,10570177
11921,1,-191,414,155.70836119999998,17449.15234,132.0952397,605,725,1294,1029.3915220000001,7804.366211,569,-762,212.9265205,36327.54077,1266,1551686,67817402,2901613
11922,1,-202,333,117.0105497,6666.933594,81.65129266,535,960,1137,1042.04314,1001.464844,177,39,141.7844425,1303.8474119999998,168,876254,69494650,1286581
11923,1,-1080,737,255.8389691,58172.689210000004,241.19015159999998,1817,558,1617,1036.57981,16910.42554,1059,-2089,341.613474,95914.23608,2772,4189029,68767853,7468785
11924,1,-747,4838,643.6780906,407963.9138,638.7205287,5585,333,2901,1086.564008,149698.4131,2568,-1782,317.76625160000003,75679.48217999999,2494,26516575,75559766,6462425
11925,1,-1555,1141,436.10196270000006,187287.4548,432.7672063,2696,313,2049,1069.357035,74433.09277,1736,-762,571.0222194,305608.4365,4563,12171835,73185566,20868248
11926,1,-1303,1363,346.58825989999997,110461.1462,332.35695610000005,2666,480,1803,1044.742432,26849.714839999997,1323,-732,438.95344289999997,174294.46,3811,7687899,69855152,12331528
11927,1,-1171,474,269.4560783,70574.54077,265.6586923,1645,637,2735,1069.646232,56359.24902,2098,-1069,261.2958991,44041.814210000004,1534,4646821,73225156,4369635
11928,1,-1676,1454,441.21848330000006,159868.1836,399.8351955,3130,-107,3294,1100.377023,163661.1211,3401,-1475,386.683232,127178.3435,2534,12459120,77493094,9569531
11929,1,-515,414,132.20828740000002,12136.33496,110.1650351,929,950,1333,1034.2247929999999,3532.406006,383,-702,189.49835090000002,26287.24121,1088,1118658,68455739,2298216
11930,1,-90,323,105.85972439999999,5063.640625,71.1592624,413,794,1196,1021.708679,8645.967773,402,19,200.5583612,3885.765625,327,717202,66808872,2574314
11931,1,-2191,1484,574.3105377,322802.8193,568.1573896000001,3675,176,2872,1098.065949,121384.5642,2696,-1118,307.865281,74456.96484,1751,21109286,77167925,6065986
11932,1,-787,707,271.2139953,47282.64746,217.44573450000001,1494,343,2549,1028.9474519999999,81569.71851,2206,-237,213.3457068,9386.697021,682,4707650,67758903,2913049
11933,1,-1222,5000,1012.420761,964179.613,981.9264805,6222,-39,3578,1296.61169,443823.7344,3617,-663,370.43958260000005,96855.88452,1900,65599731,107596920,8782431
11934,1,-1252,767,350.4568001,119662.9336,345.9233059,2019,68,2637,1105.0789,122371.3125,2569,-2801,507.2474895,244307.5779,3494,7860478,78156760,16467201
11935,1,-848,1000,234.30515630000002,54521.08984,233.49751569999998,1848,705,1421,1042.1797689999999,7688.874756,716,-1336,240.47306890000002,44962.77515,1959,3513530,69512875,3700947
11936,1,-484,454,170.89502439999998,23919.364990000002,154.65886650000002,938,852,1294,1037.1890050000002,4277.265625,442,-1049,280.195579,63365.18359,1652,1869127,68848706,5024612
11937,1,-313,616,161.2716071,21320.56152,146.01562080000002,929,833,1323,1032.4830960000002,6022.402344,490,-1178,273.9328727,56915.328129999994,1712,1664546,68225366,4802510
11938,1,-505,414,139.7536896,16046.40527,126.67440649999999,919,813,1343,1032.380721,4813.388428,530,-940,226.4728875,29061.022460000004,1474,1249990,68211837,3282558
11939,1,-252,313,115.41108590000002,9610.147461,98.03135958,565,843,1225,1027.484633,3850.0817869999996,382,-762,275.9372098,51922.20313,1415,852462,67566379,4873046
11940,1,-20,171,82.21361277,894.8688965,29.91435937,191,980,1058,1025.5425699999998,215.4960938,78,-69,166.6001013,1298.538086,286,432581,67311204,1776358
11941,1,50,90,70.94231812,66.96777344,8.183383983999999,40,1009,1058,1029.971078,101.35327149999999,49,99,130.9504319,154.4489746,69,322100,67893787,1097473
11942,1,40,80,65.66962768,87.5,9.354143467,40,1009,1049,1031.230636,88.96484375,40,99,132.93871940000002,145.4255371,59,276000,68059944,1131053
11943,1,-191,484,131.20231280000002,12777.23804,113.03644560000001,675,735,1166,1033.003623,5262.841553,431,-811,274.23307830000005,41806.21875,1622,1101699,68294175,4813042
11944,1,-919,2474,488.182311,222145.3086,471.3229345,3393,431,2098,1072.57475,85457.09277,1667,-1544,375.4806087,110338.8086,2177,15252606,73626662,9023084
11945,1,-373,787,188.5019065,29395.22559,171.45035900000002,1160,696,1490,1032.920193,11938.35938,794,-1653,353.56287010000005,103005.4705,2643,2274110,68283144,8000429
11946,1,-535,686,210.9698216,40509.67944,201.27016530000003,1221,696,1509,1022.2085310000001,21841.24902,813,-1415,455.7587767,163550.4131,2375,2848529,66874258,13293828
11947,1,-828,808,263.55265130000004,58767.14746,242.41936280000002,1636,892,1813,1043.2710949999998,18256.65601,921,-1356,342.2274235,97654.99976,2108,4445440,69658533,7495655
11948,1,-1010,1040,230.1581997,46615.22632,215.90559580000001,2050,666,2313,1046.201724,36179.33569,1647,-1752,352.14709730000004,94396.69702,2445,3390259,70050435,7936485
11949,1,-505,575,179.9623659,25858.31812,160.8052179,1080,735,1637,1029.625349,13950.98608,902,-1762,387.5130441,115889.3083,2742,2072733,67848215,9610647
11950,1,-828,1010,364.7142931,96278.40796,310.2876213,1838,58,2323,1059.5126089999999,161370.5537,2265,-712,341.38527539999995,97153.34375,2137,8513057,71844286,7458810
11951,1,-1212,2929,776.2960031,552690.2185,743.4313812,4141,58,2009,1091.7223279999998,145999.8767,1951,-2029,477.73847120000005,193189.0369,3048,38568671,76278889,14606979
11952,1,-686,2141,471.1131101,185954.3584,431.22425530000004,2827,382,1392,1012.4214710000001,34754.56616,1010,-366,287.5565705,47286.006839999995,1465,14204644,65599823,5292082
11953,1,-333,252,128.2090578,8179.296875,90.43946525,585,872,1147,1033.44911,2089.871094,275,-108,179.6023385,8838.436523,721,1052004,68353092,2064448
11954,1,-939,545,221.406089,36251.65625,190.3986771,1484,882,1284,1027.697487,4191.381836,402,-811,254.46647620000002,45605.54688,1405,3137322,67594376,4144204
11955,1,-909,636,264.7651967,65934.3103,256.7767713,1545,862,1156,1028.360399,3469.9704590000006,294,-168,194.4529586,12476.26733,583,4486439,67681607,2419965
11956,1,-393,262,128.6042257,14167.05249,119.02542790000001,655,872,1196,1027.501969,2603.304443,324,-653,217.875,25708.65601,1177,1058499,67568659,3038049
11957,1,-232,222,77.40478021,4166.608397999999,64.54927109,454,980,1068,1032.53728,367.35522460000004,88,-108,169.7926125,5439.652344,513,383456,68232527,1845090
11958,1,-262,333,100.1617442,4870.850586,69.79147932,595,901,1303,1033.809082,3285.670898,402,-831,239.5045994,33728.19507,1256,642072,68400718,3671197
11959,1,-1676,4797,885.4108068,757143.3513,870.1398457999999,6473,-1019,4117,1237.488769,434023.9978,5136,-2574,494.38386529999997,227846.8896,3375,50172947,98008221,15642586
11960,1,-1909,3313,546.1532093999999,280756.0505,529.8641812,5222,558,2196,1075.478672,51133.55859,1638,-920,238.9164341,26005.9834,1276,19090133,74025880,3653188
11961,1,-424,686,184.7469553,26031.4375,161.3426091,1110,745,1715,1068.017212,24303.4314,970,-237,184.4185965,12612.01465,652,2184412,73002289,2176654
11962,1,-1494,3525,826.2932572000001,621651.1619,788.4485791000001,5019,29,2186,1107.860642,95425.44702,2157,-1297,313.80609560000005,77344.91772,1782,43696675,78550733,6302353
11963,1,-1878,1262,484.4196108,227687.4998,477.1661134,3140,343,3421,1080.615565,112744.2344,3078,-2108,483.0346131,197186.8037,3513,15018391,74734720,14932636
11964,1,-1454,646,410.26635780000004,162143.9626,402.6710353,2100,519,2068,1039.9247189999999,42477.302489999995,1549,-1683,359.8559173,117334.3271,2514,10772383,69212379,8287762
11965,1,-545,464,184.99054030000002,25757.5,160.4914328,1009,794,1333,1041.361076,4359.851318,539,-712,197.3849744,30516.941160000002,1266,2190176,69403705,2493493
11966,1,-454,434,126.14853600000001,14449.195069999998,120.2048047,888,892,1107,1033.157463,1358.09375,215,-118,130.6705064,8014.121094,652,1018461,68314518,1092786
11967,1,-464,333,159.1660395,22293.3396,149.3095429,797,941,1117,1032.942921,947.0935059000001,176,-168,153.295976,12929.24609,682,1621365,68286149,1503978
11968,1,-858,535,198.39433590000002,37861.1709,194.57947190000002,1393,696,1137,1020.534832,7138.780273,441,-188,209.1150625,21653.65015,821,2519060,66655446,2798663
11969,1,20,171,111.29697040000002,934.6716309000001,30.57239982,151,1000,1196,1049.490055,2208.183594,196,79,145.338022,472.55249019999997,109,792769,70491480,1351881
11970,1,161,373,270.252197,1680.484375,40.99371141,212,843,1078,967.5787677999999,1452.048584,235,89,297.5696347,1356.670898,267,4674320,59917355,5667052
11971,1,222,313,266.977176,454.296875,21.31424113,91,931,1039,966.4730903999999,521.7556152,108,257,298.6029711,480.75561519999997,99,4561716,59780495,5706479
11972,1,202,303,252.80878399999997,549.9521484,23.45105858,101,901,1078,971.9139864,1441.986084,177,198,294.9031886,430.798584,138,4090386,60455475,5565945
11973,1,-353,1969,358.79146099999997,81628.74902,285.7074536,2322,676,1588,985.2020018,14230.66968,912,-49,319.94550319999996,8556.920898,583,8238804,62119871,6551368
11974,1,-454,2686,448.47254649999996,125845.9844,354.7477757,3140,470,2254,979.0820717,36671.67358,1784,148,358.262539,19317.94312,970,12872168,61350509,8214531
11975,1,191,333,275.4130988,930.4208983999999,30.50280149,142,892,1049,969.7631072999999,1085.786865,157,207,280.3746935,542.1162109,129,4854552,60188191,5031038
11976,1,232,323,280.4229785,473.1188965,21.75129643,91,921,1029,971.7117226,684.6364746,108,247,267.61571680000003,170.55249019999997,59,5032771,60430315,4583563
11977,1,232,333,283.71423230000005,555.0388184,23.55926184,101,901,1029,969.0953175000001,941.6130370999999,128,237,265.1277994,167.0898438,60,5151601,60105327,4498736
11978,1,232,323,262.9543984,460.0720215,21.44928953,91,911,1019,974.0400963999999,778.0427246,108,217,265.0794692,224.19433590000003,80,4425281,60720263,4497096
11979,1,181,292,242.675613,486.157959,22.04898998,111,911,1039,978.6977876,845.7263184000001,128,237,276.845258,389.65209960000004,79,3769053,61302359,4905171
11980,1,141,272,201.5324105,702.7646484,26.50970857,131,911,1068,981.7289197999999,970.7731934000001,157,277,300.824544,232.7148438,59,2599380,61682667,5791706
11981,1,151,212,182.89926359999998,174.4001465,13.20606476,61,931,1029,984.5785186,369.95678710000004,98,247,290.8384163,169.49780269999997,69,2140937,62041271,5413567
11982,1,131,202,170.24412619999998,305.7568359,17.48590392,71,950,1039,986.5659507000001,376.734375,89,277,303.8625049,153.7692871,49,1854916,62291992,5909275
11983,1,121,191,158.8328524,204.5898438,14.30349061,70,950,1029,982.2619225,238.27709959999999,79,297,316.1420023,139.1345215,49,1614584,61749663,6396529
11984,1,131,191,153.2147186,151.73339840000003,12.31801114,60,960,1019,987.3304127,158.78125,59,287,312.3570923,193.70092769999997,69,1502384,62388566,6244285
11985,1,131,212,168.5384322,259.89819339999997,16.1213583,81,941,1029,984.9012402999999,328.66381839999997,88,277,310.3555924,201.21777340000003,79,1817933,62081949,6164518
11986,1,121,222,163.37586069999998,310.8063965,17.62970211,101,931,1009,979.3379778999999,233.51464840000003,78,277,324.2617336,260.7770996,109,1708267,61382584,6729323
11987,1,141,222,176.52761819999998,306.8818359,17.51804315,81,921,1029,978.4769016,474.55444339999997,108,287,324.9561268,265.81030269999997,69,1994368,61274691,6758175
11988,1,151,222,187.8695525,244.10839840000003,15.62396872,71,941,1029,976.3726475,331.00561519999997,88,297,327.2845188,206.59277340000003,59,2258878,61011427,6855370
11989,1,141,222,183.9794486,222.046875,14.90123736,81,931,1009,975.4476937000001,294.20874019999997,78,297,328.7979053,360.0,69,2166300,60895885,6918916
11990,1,131,202,170.81601030000002,283.42163089999997,16.83513085,71,931,1019,969.601948,318.8710938,88,316,353.8627029,146.06933590000003,60,1867399,60168188,8014004
11991,1,-303,1565,465.0851737,79080.27734,281.2121572,1868,529,1313,938.0715424000001,35244.89746,784,108,314.38948769999996,7485.6875,426,13843470,56318606,6325808
11992,1,-686,2151,558.8397859,192650.7725,438.92000690000003,2837,196,1990,995.5957622999999,63751.63842999999,1794,-128,350.9680363,23460.76465,979,19987322,63437499,7883428
11993,1,-585,1777,568.7341069,189307.9763,435.09536460000004,2362,294,1647,926.8717465,36187.12085,1353,59,366.5487902,18045.044680000003,921,20701343,54981839,8598913
11994,1,-535,2464,558.9833405,173799.2344,416.8923535,2999,245,1617,947.1048152999999,72202.99609,1372,69,355.9868326,20593.20215,663,19997592,57408482,8110504
11995,1,-131,818,453.56495880000006,42845.8689,206.9924368,949,225,1745,931.2897222999999,93422.95874,1520,108,381.4134486,17580.57813,515,13166155,55507235,9310478
11996,1,111,474,330.5665118,4520.850586,67.23727081,363,745,1107,936.1314511,5969.714844,362,198,350.6561706,2268.647461,257,6993550,56085894,7869424
11997,1,171,404,280.2623492,2276.079834,47.70827846,233,833,1029,951.7622471000001,2163.484375,196,217,332.45683460000004,873.4333495999999,188,5027007,57974488,7073763
11998,1,141,303,224.3631264,1387.25,37.24580513,162,882,1039,962.7274892999999,979.2958983999999,157,227,352.32311610000005,1138.89624,208,3221684,59318030,7944421
11999,1,90,323,200.80968909999999,1761.390625,41.96892452,233,882,1078,972.5123312000001,1330.329834,196,257,333.355455,663.1052246,139,2580770,60529935,7112055
12000,1,131,242,190.5161575,397.9990234,19.94991287,111,931,1029,962.2995814,305.90209960000004,98,306,365.7618974,522.5446777,109,2322970,59265311,8562033
12001,1,141,252,194.5444197,610.5927734,24.710175500000002,111,911,990,949.2591272,224.96459959999999,79,346,396.5796539,298.50561519999997,99,2422242,57669945,10065627
12002,1,-292,1000,330.3427434,55396.53687,235.3646891,1292,754,1156,973.3847277000001,7638.466553,402,-118,342.2009187,10743.95313,603,6984085,60638581,7494494
12003,1,141,282,202.50219909999998,913.3356934000001,30.22144426,141,931,1088,981.0627847000001,1165.217773,157,207,344.3629989,1086.889648,189,2624457,61598988,7589496
12004,1,121,494,295.53362749999997,5132.483397999999,71.64135257,373,784,1098,955.0566901000001,3447.71875,314,207,313.6799972,1722.7282710000002,189,5589768,58376530,6297289
12005,1,151,393,282.7147138,2843.292725,53.32253487,242,862,1078,960.1878316,2429.509521,216,247,314.33285010000003,865.4821777000001,129,5115367,59005483,6323529
12006,1,181,393,287.8459332,2677.819336,51.74765054,212,833,1068,958.9462641000001,3609.3085939999996,235,267,303.43705589999996,388.09936519999997,99,5302738,58852988,5892739
12007,1,191,383,295.19228369999996,2157.1247559999997,46.44485715,192,843,1098,960.340109,3650.6835939999996,255,247,291.3067809,442.15405269999997,89,5576863,59024200,5431017
12008,1,-262,1070,298.4444567,33461.55859,182.9250081,1332,745,1343,988.8283392000001,10908.73999,598,49,321.86199,6065.80249,505,5700422,62578015,6630089
12009,1,-363,1717,406.87231180000003,110283.3533,332.0893754,2080,539,1127,953.1935221000001,14637.187259999999,588,128,356.54238,10542.90234,535,10594885,58148985,8135838
12010,1,-373,1484,445.00960310000005,95263.21265,308.6473921,1857,431,1323,960.8923424000001,25380.17871,892,138,365.4028385,8987.441162000001,456,12674147,59092102,8545231
12011,1,131,444,240.62555189999998,2719.709961,52.15083854,313,764,1176,965.3670772,3842.203125,412,207,344.44581850000003,1475.77124,208,3705642,59643750,7593147
12012,1,161,363,248.58354980000001,1722.834961,41.50704712,202,794,1107,962.8026148,4488.655272999999,313,168,326.3276967,1685.820068,297,3954802,59327288,6815345
12013,1,141,363,250.3983701,1983.303711,44.53429814,222,852,1049,969.1993877,2414.200928,197,247,314.92504069999995,719.1083984,139,4012758,60118237,6347378
12014,1,191,303,253.7028281,687.7568359,26.22511842,112,882,1049,965.8140673,1933.652344,167,287,312.4128128,169.9958496,59,4119368,59698996,6246513
12015,1,131,393,261.2655199,2363.17749,48.61252401,262,852,1137,974.5027739,4142.515625,285,227,298.31904060000005,673.8398437999999,119,4368619,60777962,5695632
12016,1,212,353,272.2659832,966.9685059000001,31.09611722,141,872,1088,965.4108986,2933.066162,216,257,297.4813807,332.5720215,79,4744241,59649165,5663691
12017,1,161,343,267.6145491,1085.8063960000002,32.95157654,182,872,1088,960.4697988,2371.648193,216,247,307.24282949999997,417.5898438,109,4583523,59040143,6041482
12018,1,181,464,292.6924314,5074.972412,71.23884061,283,705,1117,953.3112851,8142.092773,412,227,306.5994945,1378.131836,178,5482807,58163354,6016208
12019,1,131,424,298.10094239999995,5460.536865,73.8954455,293,754,1205,970.9666655999999,12968.07007,451,227,293.0147714,976.4755858999999,119,5687307,60337681,5494890
12020,1,-282,1010,330.9429473,42951.171630000004,207.2466444,1292,656,1333,975.4504568,17562.55371,677,69,328.04037,12274.27319,614,7009487,60896230,6887071
12021,1,-444,1464,400.71254889999994,98670.66187000001,314.11886580000004,1908,647,1264,972.3926274,12421.609129999999,617,89,336.6377411,7496.746094,623,10276515,60515035,7252798
12022,1,-515,1969,447.8266615,133855.6563,365.8628927,2484,578,1441,974.3716004,18989.0564,863,-89,353.5552909,11369.14746,841,12835118,60761601,8000086
12023,1,-303,1353,380.0385671,78925.30859,280.936485,1656,803,1235,986.3815502,7396.671875,432,89,327.5149329,5125.866211,396,9243476,62268708,6865026
12024,1,111,343,216.8590772,2579.361084,50.78741068,232,892,1137,979.3165586000001,2301.8396,245,227,312.56696780000004,1975.550537,188,3009783,61379899,6252679
12025,1,60,313,203.2666814,2827.808594,53.17714353,253,862,1117,978.1147364,2973.084961,255,158,315.0653702,3437.2460939999996,238,2644310,61229340,6353036
12026,1,70,262,170.8934701,2046.5681149999998,45.23901099,192,901,1068,978.0266723999999,1426.98999,167,237,330.4664081,812.7731934,149,1869093,61218315,6989315
12027,1,-202,343,163.83776269999998,6785.171875,82.37215473,545,774,1362,989.7651394,5897.795897999999,588,-376,325.8557004,10314.29688,880,1717940,62696642,6795644
12028,1,60,191,131.5633165,1290.8398439999999,35.92825968,131,921,1029,985.5721609,604.1325684,108,247,322.2776608,851.9821777000001,139,1107770,62166559,6647225
12029,1,50,181,118.0829952,790.3710937999999,28.11353933,131,901,1058,993.2610117999999,952.8271483999999,157,237,308.14644960000004,1366.0407710000002,218,892390,63140316,6077071
12030,1,40,181,116.80412290000001,1004.5251460000001,31.69424469,141,911,1088,997.0275902000001,1145.185303,177,168,308.1070989,1513.792725,257,873165,63620097,6075519
12031,1,50,191,134.20681340000002,1176.40625,34.29877913,141,921,1058,987.2112314999999,1002.95874,137,227,314.41808849999995,762.5368652000001,178,1152734,62373505,6326959
12032,1,70,202,136.6724529,886.3005370999999,29.77080008,132,921,1049,983.3800130000001,870.1210937999999,128,287,320.783416,281.8818359,79,1195479,61890320,6585728
12033,1,70,191,144.83692340000002,1092.3278810000002,33.05038397,121,911,1068,989.0733905,1164.8122560000002,157,247,321.17477230000003,603.1794434,149,1342575,62609035,6601807
12034,1,60,212,144.3000888,1592.626709,39.90772743,152,931,1058,984.9150661,878.9677733999999,127,287,328.1009753,312.109375,69,1332641,62083692,6889616
12035,1,50,202,141.3385231,1160.454834,34.06544927,152,931,1058,981.5421539999999,818.734375,127,297,330.816745,436.5693359,99,1278501,61659200,7004142
12036,1,70,202,140.5816044,719.1875,26.81767141,132,921,1019,979.8597715,490.64428710000004,98,306,341.17361780000005,224.97558590000003,70,1264844,61448011,7449564
12037,1,50,191,136.46176200000002,1040.709961,32.26003659,141,921,1049,984.7853748,1084.929443,128,277,326.8754302,337.10522460000004,99,1191796,62067343,6838243
12038,1,30,222,133.2951378,2205.03125,46.95776027,192,911,1068,988.1557316999999,1418.9335939999999,157,257,323.28412430000003,385.4023438,109,1137126,62492912,6688808
12039,1,30,202,114.77838700000001,1721.734131,41.49378424,172,911,1049,988.23679,931.0231934000001,138,287,331.5685968,407.76342769999997,79,843141,62503165,7036015
12040,1,50,161,94.90027661,599.4648437999999,24.48397116,111,892,1049,991.1292802000002,751.6875,157,277,324.76181180000003,342.30444339999997,99,576388,62869584,6750095
12041,1,40,131,89.60861077,560.9626465,23.68465002,91,950,1049,993.0651807,532.8181152,99,287,319.9465776,365.421875,69,513901,63115421,6551412
12042,1,-272,868,217.7713465,38928.70483,197.3035855,1140,607,1254,1006.981233,15729.2146,647,-49,321.58588960000003,12241.794679999999,722,3035159,64896717,6618719
12043,1,-60,282,131.91723259999998,5143.514647999999,71.71830065,342,764,1078,974.598491,4329.078125,314,138,332.51698730000004,2501.257568,277,1113738,60789902,7076323
12044,1,80,333,188.4946949,2360.734375,48.58738905,253,901,1068,979.6377599,1218.5466310000002,167,158,317.017744,4400.25,327,2273936,61420169,6432016
12045,1,-525,515,218.33847000000003,17363.05371,131.7689406,1040,588,2049,992.2436933,33038.7478,1461,-792,377.2993672,32959.25,1415,3050988,63011043,9110708
12046,1,-666,696,242.1935241,37881.18335,194.63089,1362,823,1274,976.5074243999999,3611.944336,451,148,337.8192934,3544.842773,347,3754093,61028272,7303800
12047,1,30,212,137.5792953,1742.491211,41.74315765,182,892,1068,980.6685777,1157.7282710000002,176,247,335.0654787,650.2412109,149,1211396,61549495,7185208
12048,1,-282,282,121.29831509999998,7562.464844,86.96243352,564,843,1117,990.5446812999999,1233.4470210000002,274,39,330.6201795,4404.566162,525,941650,62795441,6995821
12049,1,30,181,105.5230277,1050.5563960000002,32.41228774,151,911,1088,986.4691296,863.7177733999999,177,247,342.3331482,1198.5251460000002,188,712647,62279766,7500287
12050,1,-303,363,125.6008683,8419.835693,91.75966267,666,872,1156,988.6421242999999,1824.920898,284,79,335.51462339999995,3133.152344,406,1009637,62554448,7204484
12051,1,20,181,109.76644240000002,1970.394287,44.38912352,161,931,1029,980.6164595,442.86303710000004,98,267,346.0394215,653.5849609,119,771115,61542953,7663570
12052,1,-272,414,154.0255661,11423.67871,106.88161070000001,686,901,1088,987.5500619999999,1147.811523,187,128,335.018423,4016.905273,446,1518328,62416328,7183190
12053,1,-272,353,149.21492469999998,6889.09375,83.00056476,625,931,1088,980.3818213,1024.12085,157,247,342.0285076,1064.530273,168,1424966,61513505,7486944
12054,1,-515,282,158.9123186,10513.64746,102.5360788,797,862,1127,978.286616,2851.517334,265,277,356.44091380000003,1246.9023439999999,148,1616200,61250861,8131208
12055,1,10,191,116.31725209999999,1494.92749,38.66429219,181,892,1078,965.2902332,1133.11499,186,326,391.3104187,706.8037109,149,865901,59634255,9799926
12056,1,-494,888,279.2123968,41574.0,203.89703280000003,1382,549,1156,939.0206417000002,13689.05249,607,69,415.3336197,11638.35327,643,4989412,56432625,11040129
12057,1,-333,1232,334.5828793,62876.53101,250.7519312,1565,696,1254,992.917631,7609.884520999999,558,89,335.03479300000004,4725.803711,524,7164525,63096667,7183892
12058,1,-181,464,145.3335065,5234.013428,72.34648179,645,676,1196,985.0395930999999,5365.152344,520,69,345.7903538,3524.288086,366,1351797,62099392,7652542
12059,1,-727,2181,645.1197804999999,328156.0586,572.8490714,2908,500,1421,981.1734684,21498.225590000002,921,-79,388.12097420000003,20621.3064,831,26635490,61612888,9640825
12060,1,-616,4121,580.9953473999999,297091.7568,545.0612414,4737,88,3274,1051.825192,119325.031,3186,-257,371.6233182,22663.21069,1356,21603558,70805519,8838649
12061,1,141,252,185.6452851,613.9216309,24.77744198,111,921,1039,987.4656877,641.8708496,118,227,278.7600335,336.2568359,99,2205707,62405663,4973258
12062,1,50,181,130.7357784,643.78125,25.37284474,131,931,1049,995.1215535,490.640625,118,227,298.5019368,857.2773437999999,149,1093878,63377082,5702618
12063,1,-636,1010,234.3814332,45483.1709,213.26783840000002,1646,656,1284,990.9105109,10416.19897,628,69,346.2796242,12048.65015,643,3515818,62841833,7674213
12064,1,-696,505,191.5496835,28669.839839999997,169.3217052,1201,833,1343,993.5654073999999,3914.053711,510,-69,326.37713039999994,7906.405273,573,2348242,63179022,6817410
12065,1,-50,181,88.23105321,1870.147461,43.24520159,231,941,1039,996.4208135,402.6396484,98,217,311.58739239999994,996.3903809000001,169,498222,63542684,6213549
12066,1,0,161,87.46088411,1143.975586,33.82270814,161,921,1029,992.1324729,386.8398438,108,277,320.4695042,690.3317871,119,489562,62996918,6572845
12067,1,20,141,87.70164266,622.4470215,24.94888818,121,960,1039,992.1454971000001,288.6875,79,277,324.5882488,341.0273438,119,492261,62998572,6742882
12068,1,-737,606,179.7797698,21233.333740000002,145.7166214,1343,784,1607,991.3089595,9850.282959,823,-722,367.8505981,33293.70996,1405,2068529,62892381,8660100
12069,1,-606,464,187.5025416,24583.579830000002,156.7915171,1070,852,1107,986.8174936,1520.325928,255,118,341.3199333,3088.210693,396,2250061,62323761,7455955
12070,1,-222,343,136.3182169,5968.558594,77.25644694,565,931,1078,987.2123869,1066.907959,147,188,344.7550081,4263.187256,396,1189290,62373651,7606785
12071,1,-50,323,162.25842619999997,6460.013428,80.37420872,373,745,1196,977.2590736,6450.607178,451,198,354.10805639999995,5102.767334,336,1684979,61122259,8025121
12072,1,-808,969,379.91578010000006,95577.83984,309.1566591,1777,401,1362,976.0077004000001,31590.933589999997,961,-89,389.5576819,13789.37109,811,9237504,60965826,9712332
12073,1,-727,1484,422.78603480000004,133285.7959,365.08327260000004,2211,39,1696,1075.456531,62163.850589999995,1657,-198,376.46754510000005,27357.027339999997,1217,11439874,74022832,9070580
12074,1,30,252,147.919108,1990.249023,44.61220711,222,882,1166,999.0621382999999,3617.59375,284,217,291.9590083,922.421875,129,1400324,63880010,5455364
12075,1,-767,848,302.01847000000004,87246.15625,295.37460330000005,1615,568,1323,1031.336663,22809.01465,755,-99,293.7400796,12579.468509999999,613,5837770,68073940,5522127
12076,1,-242,1070,321.863592,42702.89819,206.64679569999998,1312,656,1215,980.7901630000001,11994.53809,559,168,328.0814019,7662.871094,376,6630155,61564758,6888794
12077,1,-656,1484,391.32429410000003,97681.81226,312.54089689999995,2140,352,1284,989.2655814,30122.57202,932,0,312.9523226,14255.51465,683,9800621,62633369,6268106
12078,1,50,454,237.1736903,8679.659912000001,93.16469241,404,735,1196,993.8726182,9105.389648,461,148,310.0094505,2651.45874,297,3600087,63218098,6150775
12079,1,-777,1626,501.9173706,189881.1345,435.753525,2403,431,1539,982.4144842000001,37588.64746,1108,-287,373.3536778,41892.90625,1158,16122947,61768846,8921150
12080,1,-454,1181,360.0731913,80167.3103,283.1383236,1635,627,1323,998.2244863,17836.5625,696,-297,343.1680756,19746.41577,900,8297773,63772936,7536917
12081,1,90,484,276.01270919999996,6956.472412,83.40546992,394,764,1156,962.9192268999999,6813.046875,392,217,328.06158910000005,2911.491211,238,4875713,59341660,6887962
12082,1,80,525,298.85688460000006,8481.839844,92.09690464,445,745,1147,962.8240688,8667.339844,402,217,321.25267510000003,1342.569336,169,5716188,59329932,6605010
12083,1,141,393,292.7302779,4100.448975,64.03474818,252,813,1127,956.8472481000001,4605.714844,314,277,321.9447255,627.4677734,99,5484225,58595626,6633498
12084,1,-303,1717,416.8432334,100113.8906,316.40779169999996,2020,509,1166,965.3790382999999,9576.522461,657,79,332.8028931,10733.82007,653,11120530,59645228,7088497
12085,1,-393,2070,395.77629410000003,94560.03809,307.50615939999994,2463,441,1715,982.1929387,30157.82715,1274,-79,353.7539752,16159.359380000002,940,10024888,61740990,8009080
12086,1,-494,2161,472.2481141,150101.4053,387.42922610000005,2655,431,1519,992.3833369999999,28524.053710000004,1088,-29,355.7431702,13856.61499,989,14273170,63028780,8099405
12087,1,-575,2595,627.0844491,311045.1836,557.7142491000001,3170,431,1774,990.1046504000001,60746.08984,1343,-227,370.3248363,28765.78687,1167,25167034,62739662,8776991
12088,1,-222,757,257.1803842,25046.8584,158.2619929,979,617,1166,987.1708707999999,11194.749759999999,549,198,318.11033860000003,2460.764648,227,4233072,62368405,6476428
12089,1,60,141,103.61866690000001,526.3571777,22.94247541,81,931,1039,993.6965393999999,390.5625,108,257,303.78616039999997,325.46875,79,687157,63195700,5906306
12090,1,30,141,95.90270134,527.9724121,22.97765027,111,960,1049,999.6578086000001,471.6501465,89,227,298.12971689999995,644.4821777000001,129,588629,63956207,5688405
12091,1,0,232,109.76252779999999,2308.589844,48.04778708,232,941,1098,1000.9486130000001,960.4052733999999,157,158,288.5098839,2039.6696780000002,257,771060,64121480,5327229
12092,1,20,232,116.57555220000002,2130.825928,46.16087009,212,931,1058,994.565483,938.1162108999999,127,217,313.06401600000004,2383.179443,218,869751,63306272,6272581
12093,1,-60,282,126.88411299999999,3000.060303,54.77280623,342,696,1147,992.8168811,2891.948975,451,-59,318.72365089999994,7709.550537,732,1030373,63083863,6501425
12094,1,20,202,121.9560628,1402.7773439999999,37.453669299999994,182,882,1137,1002.1906630000001,1696.819336,255,39,293.6666637,5717.179443,465,951890,64280712,5519367
12095,1,20,242,114.8811206,2090.488037,45.72185514,222,882,1098,1002.642057,1537.578125,216,188,284.5402816,2028.5134280000002,208,844651,64338630,5181643
12096,1,10,191,107.33584850000001,940.9333495999999,30.67463691,181,911,1098,1003.765582,1222.881836,187,198,282.8019128,1112.486084,148,737343,64482902,5118523
12097,1,-30,262,115.02737450000001,2804.972412,52.96199026,292,911,1117,1001.6762980000001,1917.389648,206,158,284.9472813,3519.52124,287,846803,64214746,5196477
12098,1,-30,181,73.27047495,1678.0,40.963398299999994,211,950,1078,1005.4980029999999,592.9118652000001,128,178,292.0568224,1088.4023439999999,188,343588,64705679,5459020
12099,1,141,282,218.94855269999996,1106.803711,33.26865959,141,882,1088,984.9030806,2485.198975,206,207,288.77932749999997,521.484375,119,3068062,62082181,5337184
12100,1,70,292,196.7390801,2219.2966309999997,47.10941128,222,833,1147,991.1893897,4582.640625,314,247,289.3046891,293.56811519999997,79,2477201,62877210,5356621
12101,1,111,232,189.5715976,564.0095215,23.74888464,121,901,1156,987.1133025,1796.0681149999998,255,227,285.6614856,297.30834960000004,99,2299993,62361131,5222559
12102,1,-333,929,253.14580159999997,27786.593510000002,166.6931118,1262,725,1323,986.8987806,6789.154053,598,99,310.22877139999997,4044.261475,316,4101299,62334029,6159481
12103,1,-656,1040,297.0719347,65896.81226,256.7037441,1696,441,1205,946.239498,25929.49609,764,128,335.8910259,8251.390625,634,5648111,57303628,7220658
12104,1,-707,2565,498.55345439999996,157813.3982,397.25734500000004,3272,352,1637,1004.251875,54267.5896,1285,99,395.9107972,15944.52319,871,15907555,64545397,10031703
12105,1,-434,1777,443.0722641,83354.02246000001,288.710967,2211,421,1519,932.1034344000001,31877.72559,1098,138,369.6938556,7129.790770999999,555,12564034,55604276,8747107
12106,1,90,555,318.435433,11476.10938,107.1266044,465,607,1245,944.8985561000001,13809.83984,638,237,342.6663373,3492.874023,297,6489672,57141330,7514894
12107,1,141,373,251.06874680000004,2803.618896,52.94921054,232,794,1137,970.1858794,4508.87085,343,217,319.1214747,1557.439209,218,4034273,60240681,6517665
12108,1,202,313,253.85945919999997,593.6523437999999,24.36498192,111,862,1049,965.4127679,1580.709961,187,277,332.611424,416.73413089999997,99,4124456,59649396,7080343
12109,1,181,323,250.1943619,1325.499023,36.40740342,142,843,1049,959.5426563999999,2688.6521,206,287,331.4192256,267.35913089999997,79,4006222,58926215,7029677
12110,1,171,303,239.1880798,715.5898437999999,26.75051109,132,872,1058,962.9276728,2356.80249,186,267,329.0677172,332.2460938,99,3661500,59342701,6930276
12111,1,171,292,229.47320789999998,695.3259277000001,26.3690335,121,852,1058,971.5526394999999,1983.624023,206,297,323.84706560000006,194.34155269999997,59,3370109,60410530,6712123
12112,1,151,282,226.66919040000002,1293.880615,35.97055206,131,833,1117,966.4991917000001,5005.428711,284,277,330.606025,400.34375,89,3288251,59783724,6995222
12113,1,141,292,228.78917009999998,1754.6345210000002,41.88835783,151,852,1107,968.4656195,5735.40625,255,277,329.14173430000005,524.6630859,99,3350047,60027242,6933394
12114,1,151,272,223.5018526,828.5114746,28.78387525,121,862,1078,971.7249642999999,2621.765625,216,277,319.1986793,395.7751465,79,3196997,60431962,6520819
12115,1,151,272,205.7269504,943.1188965,30.71024091,121,862,1068,976.5762499,2192.372803,206,277,322.83611360000003,317.6630859,99,2708709,61036875,6670282
12116,1,111,222,179.9098298,600.0544434,24.49600872,111,901,1058,980.7979531999999,1442.1210939999999,157,277,315.5684355,299.3662109,79,2071523,61565736,6373340
12117,1,101,212,158.71210180000003,599.3710937999999,24.48205657,111,931,1078,987.5167562,773.578125,147,267,302.86063210000003,218.3125,69,1612130,62412118,5870372
12118,1,-414,505,217.5438892,30797.027339999997,175.49081840000002,919,666,1313,1019.397271,12590.22437,647,99,288.4186952,3184.756836,336,3028822,66506931,5323862
12119,1,-1252,1040,289.5219389,65602.17163,256.12920890000004,2292,519,2049,1002.999244,52424.71851,1530,0,345.21345299999996,6727.376709,445,5364669,64384479,7627029
12120,1,-555,2757,561.0759473999999,245834.3281,495.8168291999999,3312,137,1754,1005.1656109999999,54057.27246,1617,138,385.7375849,21355.64038,901,20147598,64662906,9522783
12121,1,-434,1383,385.162912,86427.25684,293.98513030000004,1817,362,1382,971.0378870999999,25539.72437,1020,-9,383.3532151,24306.51465,999,9494430,60346533,9405420
12122,1,-242,1737,428.4964447,107493.5662,327.86211460000004,1979,421,1245,981.2701511,18015.982180000003,824,-29,329.49006529999997,7409.888428,593,11750989,61625031,6948077
12123,1,-464,1393,357.2375566,67555.38452,259.91418680000004,1857,607,1313,968.2956596000001,10739.00757,706,29,323.6294418,8083.034912,475,8167595,60006175,6703105
12124,1,-444,1595,391.1821227,86063.80443999999,293.3663315,2039,460,1411,975.0277079,16435.96484,951,-207,344.0501871,9594.246094,850,9793501,60843458,7575714
12125,1,-363,1494,355.57985210000004,63655.46484,252.3003465,1857,529,1480,972.8445404999999,21703.85938,951,49,342.92293689999997,7486.236084,525,8091970,60571296,7526153
12126,1,-414,2686,436.97355830000004,129666.4353,360.09225939999993,3100,205,2186,993.5613893,54642.064210000004,1981,-237,359.827476,22832.74609,1444,12220537,63178511,8286452
12127,1,-191,1585,354.58664310000006,65461.4375,255.8543287,1776,627,1205,980.8536619999999,10473.65625,578,19,325.04562180000005,6469.027344,545,8046828,61572730,6761898
12128,1,-282,1525,356.3978421,73723.37085,271.5204796,1807,715,1313,979.827177,9649.566162000001,598,-188,338.0417411,11271.33984,791,8129243,61443923,7313422
12129,1,-202,1373,365.5911736,77146.70215,277.7529516,1575,676,1284,972.530149,11299.95874,608,-69,324.73823589999995,9267.7146,583,8554042,60532153,6749115
12130,1,-171,1565,362.534632,71459.94116,267.31992290000005,1736,607,1509,978.8600433,16933.517330000002,902,158,333.57336150000003,5341.280272999999,416,8411607,61322687,7121356
12131,1,-232,2212,421.34928360000004,111871.1563,334.471458,2444,637,1833,986.4549613,20303.87866,1196,-79,330.0931213,5880.339844,702,11362254,62277977,6973534
12132,1,-232,2030,389.5107909,98126.40625,313.2513468,2262,500,1794,994.059598,29438.12085,1294,158,343.8554157,7711.466553,525,9709994,63241887,7567139
12133,1,-282,1474,396.448984,93801.60132,306.27047089999996,1756,490,1313,976.8744722000001,23450.72437,823,-69,317.6955844,6959.497803,583,10058995,61074159,6459551
12134,1,-282,454,209.3842908,21304.26563,145.95980830000002,736,666,1303,974.5956052000001,13296.53125,637,148,334.9706844,3109.33374,267,2805874,60789542,7181143
12135,1,-262,2111,417.4726787,125483.8662,354.23701980000004,2373,421,1303,994.6165561,21375.05859,882,-396,353.96349560000004,17336.83984,1188,11154140,63312774,8018570
12136,1,70,252,183.4910165,1330.798584,36.48011217,182,892,1088,982.5727152000001,1892.175537,196,198,304.8378924,2221.642334,207,2154813,61788745,5947273
12137,1,60,282,173.4692426,1535.8591310000002,39.19003867,222,921,1068,985.4120886,904.3259277000001,147,227,305.6087419,857.1618652000001,149,1925861,62146367,5977389
12138,1,70,252,171.2657839,1713.683594,41.39666163,182,901,1078,988.9514332999998,1942.686523,177,237,302.29181889999995,1455.328125,178,1877246,62593596,5848342
12139,1,101,313,204.52318789999998,2309.536865,48.05764107,212,901,1039,980.139491,855.2087402000001,138,227,310.990655,1658.5898439999999,188,2677103,61483099,6189772
12140,1,111,333,216.97987379999998,2209.111084,47.00118173,222,823,1147,976.566394,3392.0485840000006,324,168,317.2962683,1697.863037,297,3013137,61035643,6443323
12141,1,80,282,191.3095496,1454.811523,38.141991600000004,202,852,1078,976.2963817,2346.803711,226,267,326.66498989999997,546.048584,119,2342358,61001896,6829441
12142,1,101,252,174.8585142,1302.428711,36.08917720000001,151,901,1088,980.2010636,1190.209961,187,267,331.26132060000003,978.3896483999999,129,1956832,61490824,7022980
12143,1,-404,313,179.20244309999998,8909.657959,94.39098452,717,882,1088,986.7080764000001,1674.12085,206,178,304.6814422,1437.9335939999999,277,2055265,62309941,5941170
12144,1,-60,343,168.86514590000002,3640.233398,60.33434676,403,901,1215,990.7970907,1702.621094,314,0,312.673177,4691.853271,435,1824988,62827448,6256929
12145,1,-373,444,190.1224112,20419.80371,142.89787859999998,817,735,1421,995.9682946,8756.652344,686,-594,340.3004876,24836.20679,1148,2313378,63484982,7411483
12146,1,-60,282,156.08195959999998,2812.255615,53.03070446,342,882,1098,987.9271149,1429.974365,216,148,309.1969184,2339.300537,248,1559141,62463999,6118575
12147,1,90,232,169.0748725,947.25,30.77742679,142,911,1107,987.6416354,1390.3710939999999,196,237,320.05229060000005,1408.819336,168,1829524,62427904,6555742
12148,1,-40,303,176.8215467,2530.3122559999997,50.30220925,343,843,1401,989.6537509999999,6324.779053,558,-257,317.6059125,9811.023193,742,2001015,62682531,6455905
12149,1,-383,383,192.210903,14966.96875,122.3395633,766,774,1196,989.2681481000001,5037.577147999999,422,118,302.6381399,2636.78125,258,2364482,62633694,5861750
12150,1,101,262,176.05135080000002,1544.3005369999998,39.29758946,161,901,1049,982.9231038999999,1107.886475,148,217,312.0169767,1409.53125,169,1983621,61832821,6230694
12151,1,80,242,169.074549,1397.2849119999998,37.38027437,162,862,1058,982.9567402000001,1174.011475,196,217,318.8443488,2200.328125,268,1829517,61837053,6506350
12152,1,-40,363,170.2248054,3431.4548340000006,58.57862096,403,882,1264,992.3102542000001,3310.792725,382,39,305.9868257,4152.171875,347,1854495,63019497,5992188
12153,1,-313,343,185.84793009999999,11563.52515,107.53383259999998,656,872,1176,983.9607858999999,1859.109131,304,188,323.4852441,2232.7028809999997,316,2210525,61963445,6697133
12154,1,-303,1262,282.1696631,39482.100589999995,198.70103319999998,1565,715,1588,992.6592048,16224.34155,873,-376,341.4352748,11915.687259999999,871,5095662,63063827,7460995
12155,1,-656,1040,337.7396603,77914.62085,279.1319058,1696,-254,3411,1139.418821,255515.1631,3665,-19,297.8331643,17165.06152,771,7300357,83089616,5677094
12156,1,-464,2363,488.3151038,174687.4998,417.95633710000004,2827,313,1950,1020.1628699999999,70630.40234,1637,59,351.66294680000004,11682.48022,812,15260905,66606866,7914677
12157,1,-494,2373,447.8618823,167268.3123,408.984489,2867,235,1882,975.0821118999999,70296.13184,1647,-495,348.14990930000005,23561.87476,1247,12837137,60850248,7757335
12158,1,-787,2424,564.0093915,224604.4209,473.9244886,3211,441,1794,1007.0002789999999,48681.905269999996,1353,-49,372.4660849,21349.80054,979,20358822,64899172,8878783
12159,1,-282,1757,381.5250852,79937.36108,282.7319598,2039,352,1578,1004.581318,50130.65234,1226,-128,318.45378389999996,9300.5625,692,9315929,64587752,6490420
12160,1,-171,454,207.5929385,5537.599365,74.41504798,625,705,1137,977.138648,7097.6875,432,198,316.0507525,1537.2380369999998,198,2758069,61107196,6392837
12161,1,-727,1434,357.5302435,78349.43359,279.90968829999997,2161,509,1598,994.2785151,36288.24585,1089,-1049,390.6024794,46243.35327,1791,8180984,63269745,9764499
12162,1,-10,505,248.0861431,14667.718509999999,121.1103567,515,696,1343,987.3896062000001,24587.43335,647,-39,325.9891198,7437.265625,543,3938991,62396047,6801210
12163,1,-515,717,280.45693739999996,42958.71484,207.26484230000003,1232,686,2127,1007.4206849999999,58290.18359,1441,-980,422.550903,82303.89818999999,2049,5033990,64953372,11427153
12164,1,-161,808,237.0166133,20231.08496,142.2360185,969,754,1411,986.1477687999999,6229.140381,657,-861,392.7661518,88264.42871000001,1979,3595320,62239195,9872976
12165,1,-181,434,174.04368169999998,9424.497803,97.07985271,615,676,1803,1031.744821,12975.30859,1127,9,222.1949102,7223.771240000001,565,1938637,68127832,3159717
12166,1,-2484,3868,772.0236193,587705.3086,766.6194027,6352,-1303,3490,1160.017174,342074.1709,4793,-1534,366.8588582,88662.27124,2266,38145310,86120950,8613467
12167,1,-1040,2858,684.6774674,418010.4705,646.5372924,3898,205,2186,1102.407848,141035.5928,1981,-1405,386.06122,126076.8103,2127,30002127,77779396,9538769
12168,1,-1383,727,387.837756,137978.9053,371.45511880000004,2110,794,1186,1026.993876,5724.380615,392,-247,231.1248648,22821.04077,870,9626760,67501851,3418797
12169,1,-777,515,209.0957092,31514.218510000002,177.5224451,1292,794,1303,1025.286225,4554.964844,509,-752,226.3787272,31273.689210000004,1276,2798145,67277558,3279829
12170,1,-232,282,124.5961602,7865.218506,88.68606715,514,921,1098,1023.668151,696.032959,177,19,151.6363351,1800.5876460000002,218,993549,67065375,1471589
12171,1,-292,222,130.0335894,7005.374756,83.6981168,514,950,1107,1023.363709,488.515625,157,89,170.6331042,1818.420898,307,1082159,67025490,1863402
12172,1,-202,464,141.36682119999998,7653.169678,87.48239639,666,852,1156,1024.452659,1119.241211,304,19,163.5051605,2573.121094,238,1279013,67168208,1710972
12173,1,-505,353,152.022819,16968.29688,130.2624154,858,941,1068,1026.554599,625.28125,127,-19,149.21173090000002,2607.224365,246,1479100,67444118,1424905
12174,1,-10,161,103.4315897,921.828125,30.36162257,171,980,1058,1026.276423,214.57983399999998,78,79,156.44977230000003,441.8427734,128,684678,67407571,1566498
12175,1,-70,181,103.2952383,1780.952148,42.20132875,251,990,1058,1022.49404,243.421875,68,108,166.2061032,553.9365234,109,682874,66911620,1767966
12176,1,50,181,113.54679650000001,779.1210937999999,27.91274071,131,1000,1078,1026.044772,220.1210938,78,108,162.05593169999997,401.4648438,90,825144,67377144,1680776
12177,1,-515,2909,430.40576789999994,147053.3086,383.4753038,3424,392,3107,1072.7099150000001,100209.6836,2715,-2000,408.745279,144125.1873,2792,11855944,73645220,10692653
12178,1,131,464,204.0470611,2561.032959,50.60664936,333,450,1245,1003.294799,11999.39624,795,-1029,234.37966659999998,32867.65405,1603,2664653,64422429,3515765
12179,1,-747,434,221.6246827,17910.069340000002,133.8285072,1181,784,1460,1020.101695,7208.152344,676,-376,177.09712199999998,7168.560303,762,3143520,66598878,2007257
12180,1,-1303,2000,397.4400309,117927.32199999999,343.4054776,3303,117,1843,1031.364789,51520.13452,1726,-851,259.50731559999997,41898.81226,1494,10109349,68077653,4310019
12181,1,40,505,224.40417639999998,5088.023193,71.33038058,465,617,1441,1014.2030890000001,12354.89746,824,59,150.0015104,905.2321777000001,188,3222863,65830906,1440029
12182,1,-60,494,230.87882369999997,6905.178711,83.09740496,554,607,1558,1012.5562789999999,18885.05859,951,59,171.5286966,1855.717773,287,3411522,65617294,1883014
12183,1,-1121,1626,345.08846239999997,91804.29858,302.9922418,2747,-401,2343,1051.6985220000001,82621.41309,2744,-1247,255.21170750000002,44103.484130000004,1623,7621507,70788466,4168513
12184,1,-323,454,180.2193108,13692.87109,117.01654199999999,777,931,1127,1015.546058,1013.638428,196,39,195.7005445,3160.029053,267,2078656,66005363,2451117
12185,1,-272,363,123.89864809999999,7290.202148,85.38268061,635,941,1147,1021.905481,828.5625,206,99,203.4238187,1318.725586,188,982456,66834612,2648400
12186,1,-40,222,105.620562,1579.24585,39.73972634,262,990,1058,1020.7145320000001,182.765625,68,118,189.31364519999997,917.390625,188,713965,66678922,2293738
12187,1,-30,393,132.2261321,5684.359375,75.39469063,423,843,1156,1021.0447539999999,1845.49585,313,-198,185.79815159999998,4489.14624,475,1118960,66722073,2209341
12188,1,-979,797,274.8840096,48634.45996,220.53221980000004,1776,490,1568,1022.442893,23773.90625,1078,-1455,351.8031454,90874.23022,2247,4835918,66904926,7920989
12189,1,-535,777,305.94528210000004,75127.75952,274.0944354,1312,725,1480,1038.58329,15887.55371,755,-9,190.18293,10112.52515,543,5990561,69033936,2314851
12190,1,-878,2898,532.6447866999999,228161.8711,477.6629262,3776,156,1852,1051.023177,111450.6162,1696,-376,223.81671490000002,40046.99194,1415,18157470,70697582,3206011
12191,1,-393,2777,626.1671477000001,293145.5603,541.4291831,3170,-245,1754,1090.523555,249856.6396,1999,-613,277.10289720000003,75357.41187000001,1543,25093459,76111464,4914305
12192,1,-1131,3757,798.6932099999999,548547.2148,740.6397335,4888,-598,2333,1157.521956,319725.5154,2931,-564,314.17958639999995,95903.12402,1762,40826294,85750853,6317364
12193,1,-595,2969,690.8657951,291089.8123,539.5273971,3564,-333,1764,1096.264916,360305.8767,2097,-653,228.30941180000002,52092.125,1247,30546915,76914993,3336012
12194,1,-1090,3171,702.674767,415971.8474,644.9587951000001,4261,-392,2078,1118.6949220000001,251384.5759,2470,-594,294.6798316,85649.1853,1574,31600117,80094613,5557517
12195,1,-343,1767,479.4765538,116549.8142,341.39392819999995,2110,-156,1882,1043.910025,209464.3982,2038,-633,275.8565354,72212.03296,1722,14713457,69743881,4870197
12196,1,-616,2646,589.459856,212188.3806,460.63910020000003,3262,-196,1882,1091.23309,203995.7656,2078,-584,203.5336274,41370.62109,1148,22237627,76210538,2651260
12197,1,-1191,3060,702.8866818,419486.5586,647.6778201000001,4251,186,2333,1085.7385160000001,141167.5693,2147,-1227,259.3834637,64157.765629999994,1791,31619180,75445000,4305906
12198,1,30,929,408.2628022,41462.05835,203.6223425,899,9,1558,1033.294368,154418.3818,1549,-435,178.1275,31126.089839999997,821,10667425,68332624,2030682
12199,1,-1242,3606,660.0344096,302272.0994,549.7927786,4848,98,1931,1019.4932560000001,146636.7881,1833,-297,145.6349246,20680.53125,762,27881307,66519456,1357410
12200,1,-383,2303,471.3113853,117835.7009,343.27205089999995,2686,-9,1833,1063.8048529999999,155011.8201,1842,-386,201.11719219999998,38050.186519999996,1257,14216603,72427569,2588680
12201,1,-313,1121,378.4142902,75532.35938,274.83151089999996,1434,127,1950,1028.1887060000001,165770.4958,1823,-287,130.13772749999998,12094.71265,603,9164632,67659009,1083893
12202,1,-1838,1595,530.1426842,256563.90600000002,506.52137760000005,3433,-882,3980,1189.380833,292516.8962,4862,-1435,361.34860249999997,89604.52246000001,3128,17987281,90536113,8356660
12203,1,-2383,3878,638.7888687000001,356805.5781,597.3320501000001,6261,29,2529,1045.109549,96312.34277,2500,-1257,248.216293,45078.9939,1752,26115278,69904254,3943125
12204,1,-373,1565,331.6086973,71701.30054,267.7709852,1938,696,1500,1028.8570109999998,20695.1875,804,-683,236.3967798,37633.11621,1128,7037717,67746992,3576540
12205,1,-585,2202,415.0574885,124735.0928,353.1785565,2787,88,2107,1030.5659699999999,64314.953129999994,2019,-1188,293.42154510000006,75784.4353,1692,11025454,67972238,5510157
12206,1,-2545,2818,569.686468,279803.8123,528.9648497,5363,29,2254,1043.7559880000001,91363.12402,2225,-2039,345.7614559,104287.1541,2563,20770731,69723300,7651263
12207,1,-878,1949,361.419986,84640.96484,290.93120289999996,2827,549,1764,1029.6588789999998,36306.39063,1215,-574,186.4398361,14869.99902,960,8359962,67852634,2224628
12208,1,40,909,240.8980918,12122.13257,110.10055659999999,869,686,1392,1010.9000710000001,8279.005615,706,-108,141.6808142,4280.032959,335,3714041,65402813,1284701
12209,1,-10,535,210.2741886,8073.659912,89.85354702,545,852,1245,1018.553348,3193.7028809999997,393,-376,205.1239717,27502.82715,1069,2829775,66396859,2692854
12210,1,-424,1666,405.0126541,120576.0303,347.2405942,2090,460,1617,1042.424945,39193.46655,1157,-554,258.1416762,64020.163089999995,1643,10498256,69545585,4264776
12211,1,-1050,3222,583.6229653,304212.3181,551.5544562000001,4272,19,1823,1012.548533,152139.4912,1804,-702,239.7593194,54462.96777,1622,21799409,65616290,3679010
12212,1,-2363,4333,1350.0986189999999,1634518.7659999998,1278.482994,6696,-421,2539,1176.087867,290994.3845,2960,-564,299.7042813,72922.65625,1613,116657042,88523691,5748650
12213,1,-959,3313,621.8671607999999,306053.8904,553.2213756,4272,78,1813,1054.623659,115353.6211,1735,-415,164.285955,17379.74902,890,24750001,71182788,1727352
12214,1,0,979,367.7495751,33817.405269999996,183.8950931,979,-107,1607,1064.9954300000002,131306.9041,1714,-534,179.312097,28102.698969999998,1256,8655344,72589777,2057781
12215,1,-353,1101,383.5990338,70626.82813,265.75708480000003,1454,137,1931,1043.118993,168206.4412,1794,-495,222.8460441,47514.064210000004,1168,9417486,69638223,3178263
12216,1,-1575,4262,876.9826644999999,698823.8975,835.9568754,5837,-1156,4676,1217.829159,456907.2029,5832,-1504,392.6900814,123108.3818,2830,49222310,94918903,9869152
12217,1,-3212,5121,841.2535011,663482.6775,814.5444600999999,8333,-2186,4676,1208.593268,435351.585,6862,-990,260.31534359999995,39176.66577,1702,45293277,93484652,4336901
12218,1,-131,696,310.2899853,29586.8125,172.0081757,827,343,1764,1034.560248,87738.34375,1421,-178,151.28816669999998,14195.46069,643,6161912,68500154,1464839
12219,1,-444,1212,318.6160503,57795.99121,240.40796830000002,1656,539,1294,1023.4311769999999,14075.59277,755,-524,190.9793019,21003.95313,840,6497036,67034328,2334278
12220,1,-2020,858,404.6620117,128536.4756,358.51983989999997,2878,539,2617,1091.9559359999998,108003.5017,2078,-3564,757.0064708,561085.6501,4504,10480086,76311537,36675763
12221,1,-393,343,193.3714043,15032.90527,122.60874879999999,736,950,1078,1011.5177869999999,636.4743652000001,128,79,195.3856763,2430.933594,237,2393120,65482767,2443236
12222,1,-414,404,175.32768430000002,14455.64429,120.23162759999998,818,941,1098,1020.879018,709.9365234,157,49,197.71764119999997,2653.034912,277,1967347,66700414,2501905
12223,1,-353,404,180.1810288,15398.23022,124.08960559999998,757,941,1137,1019.477708,1196.6911619999998,196,9,180.8364247,3031.75,288,2077773,66517427,2092916
12224,1,-525,595,189.99457230000002,19092.14746,138.1743372,1120,960,1196,1022.4107539999999,1031.366211,236,0,180.31474219999998,2346.058594,366,2310268,66900720,2080858
12225,1,40,232,144.2604524,1607.1813960000002,40.08966695,192,970,1068,1014.976039,427.08569339999997,98,79,167.15524219999998,1177.959961,138,1331909,65931287,1788216
12226,1,70,242,150.9306028,1258.23999,35.47167871,172,990,1068,1017.729658,213.015625,78,108,162.7347343,802.53125,109,1457923,66289514,1694886
12227,1,-373,555,184.67822519999999,23123.66187,152.0646634,928,431,1617,1021.3938929999999,55054.16577000001,1186,-108,196.731813,10542.37109,751,2182787,66767711,2477018
12228,1,-1333,3444,979.2671766000001,876586.2341,936.2618405999999,4777,-166,2666,1099.781029,233929.9834,2832,-732,419.8434603999999,160612.2656,2345,61373709,77409172,11281186
12229,1,-1505,3303,674.6559308,365254.3506,604.3627640999999,4808,-166,1823,1055.284966,125807.7849,1989,-376,163.13247109999998,21403.423580000002,851,29130280,71272087,1703181
12230,1,-323,1828,412.61422660000005,77834.5,278.98835099999997,2151,303,1480,1011.289268,39416.83179,1177,-801,222.4040875,47383.36304,1315,10896032,65453183,3165669
12231,1,-959,545,296.9116293,66127.46265,257.1526058,1504,852,1156,1022.204083,2460.1875,304,-99,150.98830669999998,5480.553711,455,5642017,66873676,1459038
12232,1,-363,494,192.8477379,24315.09277,155.9329753,857,931,1147,1019.365152,1381.0898439999999,216,49,175.2275752,2674.618896,248,2380176,66502740,1965101
12233,1,-272,363,144.8358446,11462.02905,107.06086609999998,635,960,1117,1023.591868,891.6005858999999,157,108,187.7654787,1824.038086,169,1342555,67055380,2256376
12234,1,-232,363,168.3570425,12175.38184,110.34211270000002,595,921,1205,1018.946476,1196.105225,284,99,179.7175736,1124.0898439999999,178,1814022,66448123,2067098
12235,1,-232,949,237.68561830000002,29315.8396,171.21868940000002,1181,-166,1686,1093.031593,112728.0273,1852,-178,171.6984093,7008.459961,524,3615645,76461956,1886742
12236,1,-121,161,92.21450876,2220.476318,47.12193033,282,970,1058,1025.7925369999998,311.63647460000004,88,89,166.5546082,844.4375,148,544225,67344021,1775388
12237,1,-202,262,125.61660420000001,6587.515625,81.16351166,464,960,1098,1025.54532,829.9020996,138,49,178.8094744,2265.073975,277,1009890,67311565,2046261
12238,1,-282,242,133.7208496,5487.314209,74.07640791,524,941,1088,1026.8441189999999,642.4365234,147,59,144.7231732,2102.945068,198,1144401,67482166,1340467
12239,1,-555,393,179.70879219999998,15799.05859,125.6943061,948,901,1088,1023.4529789999999,799.1210937999999,187,49,144.4789128,2522.374023,297,2066896,67037184,1335946
12240,1,-90,262,146.3498591,4175.308594,64.61662784,352,980,1088,1026.154487,509.3974609,108,-39,139.4603438,2557.311523,316,1370770,67391554,1244748
12241,1,-171,252,154.9728807,9870.464844,99.35021309999999,423,970,1078,1026.935665,541.720459,108,29,153.445481,1922.7321780000002,218,1537062,67494199,1506913
12242,1,-737,525,217.63207200000002,34030.686519999996,184.47408090000002,1262,421,1823,1034.025409,18807.75366,1402,-1415,286.7967486,62974.788089999995,2335,3031278,68429347,5264152
12243,1,-222,363,179.13821480000001,15222.984380000002,123.3814588,585,833,1186,1028.408677,2510.246094,353,-732,222.381956,33089.72827,1286,2053792,67687962,3165039
12244,1,-373,333,188.3158086,17657.27734,132.8806884,706,921,1186,1023.946623,1554.0273439999999,265,-39,154.47774919999998,3154.366211,316,2269622,67101868,1527256
12245,1,-101,252,115.911065,5295.952147999999,72.77329282,353,990,1088,1026.152766,377.6240234,98,69,153.7048714,1031.3398439999999,178,859864,67391328,1512012
12246,1,-292,353,122.6292048,8208.448975,90.60049103,645,960,1127,1025.7192519999999,545.8728027000001,167,29,164.68677659999997,1516.7341310000002,238,962427,67334399,1735791
12247,1,-151,252,126.81778270000001,8777.842773,93.69014235,403,980,1078,1023.4923970000001,432.1708984,98,89,171.5480982,1194.249023,138,1029296,67042348,1883440
12248,1,-70,191,99.29218247,2969.9375,54.49713295,261,1000,1058,1025.767548,228.31933590000003,58,69,160.572073,1109.8532710000002,158,630972,67340740,1650137
12249,1,-272,292,139.74547180000002,7935.564209,89.08178382,564,970,1107,1028.475016,494.92944339999997,137,19,144.95128490000002,1454.600586,218,1249843,67696695,1344696
12250,1,-525,373,159.13933559999998,11822.16187,108.7297653,898,921,1215,1030.79834,1130.15625,294,-39,155.30695409999998,2685.459961,336,1620821,68002894,1543696
12251,1,-292,222,119.91168629999999,5395.327147999999,73.45289067,514,950,1068,1025.898585,304.84375,118,99,159.5150365,898.970459,118,920244,67357946,1628483
12252,1,-858,444,198.27112119999998,27389.527339999997,165.4978167,1302,852,1117,1028.470504,1898.9978030000002,265,0,171.158324,4601.99585,396,2515932,67696101,1874891
12253,1,-393,292,139.9523356,12878.02246,113.481375,685,911,1088,1025.561165,1118.6716310000002,177,9,149.92795139999998,2123.126709,238,1253546,67313645,1438617
12254,1,-323,474,170.8188002,17703.29688,133.0537368,797,872,1225,1025.064975,2406.191162,353,39,161.2423448,2003.147461,228,1867460,67248525,1663942
12255,1,-212,252,127.59298079999999,6404.578125,80.02860817,464,970,1078,1023.8694449999999,340.55249019999997,108,69,160.8014109,932.578125,158,1041918,67091753,1654854
12256,1,-30,242,118.4487627,1954.159912,44.20588097,272,990,1049,1021.7,185.1755371,59,118,171.2069289,475.5273438,109,897927,66807737,1875956
12257,1,-70,181,137.8002971,2648.892334,51.46739098,251,1000,1078,1019.976562,207.171875,78,108,169.8858072,763.046875,119,1215291,66582540,1847116
12258,1,60,232,146.910049,963.3974608999999,31.03864464,172,970,1068,1019.602266,335.9648438,98,79,159.27766640000002,700.7460937999999,138,1381284,66533682,1623640
12259,1,101,222,173.0929122,613.1835937999999,24.76254417,121,980,1049,1017.7426849999999,207.7302246,69,118,155.23072549999998,356.5095215,89,1917514,66291211,1542181
12260,1,-363,262,188.9479922,13518.96484,116.27108340000001,625,882,1078,1009.9987779999999,1259.640625,196,69,166.8873591,1663.048584,257,2284886,65286242,1782489
12261,1,-292,272,153.3227804,8007.625,89.48533399,564,941,1058,1021.4574449999999,296.0898438,117,118,172.3315754,1131.8903810000002,218,1504504,66776020,1900683
12262,1,-898,2888,401.8285743,145317.3533,381.2051328,3786,568,2313,1036.358355,38764.18726,1745,-306,177.04316210000002,9031.390625,632,10333837,68738473,2006034
12263,1,-1020,2575,655.5953282,396379.1111,629.5864604,3595,58,2196,1152.516472,128721.6563,2138,-1217,306.93214839999996,80467.1084,1622,27507535,85010830,6029270
12264,1,-1404,646,288.9632059,67580.39233,259.9622902,2050,931,1098,1024.715929,922.6638184000001,167,-336,150.8832848,8286.907959,712,5343983,67202735,1457009
12265,1,-222,383,141.3689212,5768.335693,75.94956019,605,960,1117,1024.286543,618.9216309,157,9,169.0075812,2116.671875,278,1279051,67146427,1828068
12266,1,-313,262,168.1874884,5636.78125,75.07850058,575,931,1049,1015.044573,375.93334960000004,118,69,150.9489256,969.3649902000001,178,1810370,65940191,1458277
12267,1,121,313,197.581945,1910.152344,43.70528965,192,970,1068,1019.2860630000001,678.6071777000001,98,29,133.2530487,1706.652344,169,2498472,66492421,1136408
12268,1,-777,525,287.3940838,53124.126710000004,230.486717,1302,666,1500,1026.172934,11578.749759999999,834,-1198,265.6836112,59011.36621,1663,5286103,67393977,4517618
12269,1,-121,363,202.7438732,7231.825928,85.04014304,484,911,1088,1021.84789,1061.970459,177,-108,113.54466359999999,4135.525146,424,2630725,66827079,825113
12270,1,-3171,1808,535.7480751,262971.9287,512.8078866999999,4979,58,2970,1064.461535,96277.11693999999,2912,-4683,691.486352,463459.3896,6465,18369664,72517015,30601816
12271,1,80,232,158.9379301,949.6345215,30.8161406,152,970,1058,1020.23725,324.6657715,88,89,141.3874884,499.64428710000004,99,1616721,66616579,1279387
12272,1,-494,414,221.47209900000001,21426.41187,146.3776344,908,892,1117,1022.615214,1768.8125,225,-89,169.132437,5558.746094,395,3139193,66927480,1830770
12273,1,-141,333,176.82556730000002,7944.264648,89.13060444,474,941,1068,1016.640746,667.3085937999999,127,49,148.3410871,1569.482178,178,2001106,66147738,1408325
12274,1,-60,252,144.1694424,3488.468506,59.06325851,312,941,1068,1024.523899,369.1005859,127,39,117.2332744,793.9118652000001,139,1330229,67177550,879593
12275,1,-121,222,139.65694580000002,3565.0,59.70762095,343,990,1078,1023.2066550000001,326.95092769999997,88,79,153.497557,1201.905273,148,1248260,67004919,1507936
12276,1,-272,323,171.8331767,9605.9646,98.01002295,595,921,1078,1020.855202,597.5273437999999,157,29,146.566218,1890.405273,218,1889705,66697302,1374826
12277,1,-131,282,132.53490109999998,4333.311522999999,65.8278932,413,950,1078,1024.700398,666.765625,128,39,143.8580029,1564.7773439999999,168,1124192,67200698,1324488
12278,1,-181,212,129.1035195,5165.15625,71.86902149,393,990,1117,1025.5241039999999,498.0458984,127,89,149.598943,1009.058594,128,1066734,67308780,1432310
12279,1,-151,262,142.448675,5778.905272999999,76.01911124,413,960,1088,1017.898847,493.8193359,128,59,159.3661272,1168.694336,158,1298664,66311556,1625444
12280,1,-80,262,151.8889911,6473.579834,80.45855973,342,970,1107,1023.090264,568.2773437999999,137,59,174.10112900000001,1543.8630369999998,218,1476497,66989676,1939917
12281,1,-464,373,180.23456940000003,13345.50684,115.52275459999998,837,892,1068,1011.8210529999999,649.59375,176,89,170.79702869999997,1386.9023439999999,247,2079008,65522038,1866984
12282,1,-171,262,146.26938969999998,4368.562256,66.09510009,433,980,1058,1018.117733,303.3427734,78,59,166.325077,962.4287108999999,188,1369263,66340078,1770498
12283,1,-191,242,142.12582450000002,4908.881836,70.06341296,433,980,1068,1020.6585039999999,323.53125,88,118,169.8453341,486.7724609,99,1292784,66671602,1846236
12284,1,-242,414,165.5114233,7158.96875,84.61068934,656,960,1127,1021.700589,537.5273437999999,167,89,167.1466889,944.5524902000001,158,1753218,66807814,1788033
12285,1,90,161,134.76617480000002,302.10522460000004,17.38117443,71,990,1049,1020.405235,125.47558590000001,59,128,154.96249550000002,220.3125,60,1162363,66638518,1536856
12286,1,70,171,130.8661649,505.1032715,22.4745027,101,990,1049,1019.1468480000001,140.0720215,59,138,175.025266,227.203125,69,1096061,66474259,1960566
12287,1,40,232,169.2549852,695.5898437999999,26.3740373,192,990,1058,1015.357434,218.15625,68,99,150.7030399,426.5146484,99,1833424,65980846,1453530
12288,1,-626,1000,341.858272,100511.0662,317.03480279999997,1626,794,1490,1034.35426,11015.577879999999,696,-722,200.5271179,20681.0625,1078,7479493,68472879,2573512
12289,1,-515,656,185.1394745,16512.7334,128.5018809,1171,764,1166,1014.0391619999999,2011.4509280000002,402,59,202.2800117,2249.667725,287,2193704,65809627,2618701
12290,1,60,313,170.98876059999998,1159.9648439999999,34.05825662,253,941,1068,1020.682255,659.0114746,127,108,152.2126391,377.1240234,90,1871178,66674705,1482796
12291,1,-171,545,157.088152,9090.725586,95.34529661,716,735,1313,1026.0098380000002,6678.625,578,-485,239.16106630000002,33841.57983,1019,1579308,67372556,3660673
12292,1,-121,757,209.94288659999998,19529.93921,139.7495589,878,656,1578,1041.438143,19569.40625,922,-584,196.919122,19529.913819999998,999,2820865,69413978,2481737
12293,1,0,515,176.70685469999998,5914.491211,76.90572938,515,764,1137,1023.5227769999999,3370.359375,373,-257,181.7558458,6811.433594,544,1998420,67046328,2114252
12294,1,80,292,157.2162126,1755.217773,41.89531923,212,941,1147,1024.902511,1145.038086,206,118,162.85998590000003,853.3271483999999,139,1581884,67227210,1697496
12295,1,-404,1828,300.6815955,55749.454829999995,236.11322459999997,2232,411,2117,1028.4815640000002,33788.44702,1706,-801,207.5440842,19765.84546,1236,5786203,67697557,2756771
12296,1,50,252,177.4632004,594.1396484,24.37497997,202,941,1058,1013.2044619999999,350.9677734,117,89,157.7651538,505.0693359,99,2015564,65701330,1592950
12297,1,101,313,199.5917709,1763.109375,41.98939598,212,862,1147,1014.490774,2832.584961,285,0,123.9434095,1111.578125,198,2549560,65868258,983166
12298,1,121,232,177.98977319999997,522.5935059,22.86030415,111,980,1058,1016.261316,277.046875,78,108,168.9043738,639.6875,119,2027543,66098372,1825836
12299,1,121,232,180.6423435,523.4960938,22.88003701,111,970,1039,1009.905186,218.75561519999997,69,128,166.38838230000002,356.8710938,99,2088426,65274143,1771846
12300,1,121,202,173.5850386,337.76928710000004,18.37850068,81,980,1039,1011.0644679999999,161.95288090000003,59,148,178.894653,224.6638184,79,1928433,65424087,2048211
12301,1,-565,2989,501.4803398,204189.87399999998,451.87373679999996,3554,137,2588,1046.39536,93880.46777,2451,-1198,273.3439053999999,50841.81226,1772,16094882,70076368,4781881
12302,1,-1646,3919,579.1115232000001,287203.624,535.9138215,5565,-401,2823,1051.389312,115239.0095,3224,-1099,250.8408983,37927.52246,1663,21463690,70746847,4026954
12303,1,-525,2272,434.6100982,148371.7959,385.19059680000004,2797,176,1990,1045.050268,69819.49121000001,1814,-742,254.22686099999999,41957.52515,1286,12088700,69896324,4136403
12304,1,-525,2141,429.5546022,148784.3428,385.7257352,2666,284,1990,1068.798844,65146.453129999994,1706,-643,226.72171129999998,25997.36304,930,11809098,73109182,3289775
12305,1,-919,2909,505.6737307,222712.6052,471.92436389999995,3828,-137,2823,1085.637075,137155.7185,2960,-900,268.7488953,51453.95313,1325,16365179,75430903,4622462
12306,1,-1060,1626,402.7915481,140123.7646,374.33108960000004,2686,-764,2176,1054.447034,161142.1384,2940,-1168,253.4223254,44421.1084,1544,10383426,71158947,4110264
12307,1,-101,565,231.5038472,6965.027344,83.45673935,666,539,1558,1018.677919,18141.195069999998,1019,-148,160.6484419,3648.80835,445,3430018,66413101,1651707
12308,1,171,262,209.39593180000003,217.890625,14.76111869,91,970,1039,1012.827624,252.17749019999997,69,108,143.3099787,178.0273438,60,2806186,65652467,1314416
12309,1,121,323,229.433133,1280.671875,35.78647615,202,833,1098,1005.255215,2114.130615,265,39,133.9374854,835.5146484,149,3368932,64674435,1148112
12310,1,181,252,216.0576457,240.65625,15.513099300000002,71,970,1049,1010.372789,216.5388184,79,108,152.2013469,231.9335938,80,2987578,65334603,1482576
12311,1,90,414,217.48530840000004,1323.1188960000002,36.37470133,324,843,1058,1010.309235,1003.464844,215,19,157.3696385,580.0935059,169,3027191,65326384,1584973
12312,1,151,232,204.4396305,230.546875,15.18377012,81,980,1039,1009.2885880000001,172.50561519999997,59,108,148.513257,198.41308590000003,70,2674916,65194461,1411596
12313,1,191,262,226.2571477,391.36303710000004,19.78289759,71,980,1039,1007.7343089999999,157.31933590000003,59,99,151.2981845,377.07592769999997,89,3276307,64993820,1465033
12314,1,151,414,236.0694085,1330.491943,36.47590908,263,852,1107,1006.650409,1340.4841310000002,255,49,137.8899017,746.4130859,149,3566641,64854083,1216872
12315,1,111,434,227.7574436,1522.3005369999998,39.01666999,323,696,1107,1010.831225,2910.331787,411,39,139.33811169999998,948.8474120999999,188,3319901,65393905,1242567
12316,1,-272,636,259.3195423,10423.98438,102.0979156,908,470,1666,1015.014909,22458.87866,1196,-356,164.7760791,6746.819336,712,4303784,65936337,1737674
12317,1,131,505,253.8682298,4966.441162,70.47298179,374,617,1245,999.5653664999999,12926.75952,628,-158,161.0673869,4594.753662,415,4124741,63944379,1660333
12318,1,-292,2828,412.4970644,119507.7322,345.6989039,3120,343,2156,1035.090168,41250.092769999996,1813,-633,195.626238,18335.71484,1048,10889845,68570346,2449256
12319,1,151,363,230.2681182,2243.600586,47.36666112,212,823,1176,1020.5692960000001,4346.746094,353,59,141.02664860000002,2303.269287,198,3393498,66659948,1272865
12320,1,-424,3242,469.6322364,168584.6865,410.5906557,3666,0,2715,1038.736447,97573.60059,2715,-544,178.8883643,16034.35522,910,14115484,69054298,2048067
12321,1,-1666,4010,595.0528337999999,295357.3818,543.4679216,5676,-68,2803,1040.507561,99614.71851,2871,-693,187.66222150000002,16392.41187,1069,22661624,69289983,2253895
12322,1,161,353,228.4774332,998.7333983999999,31.60274353,192,862,1078,1004.017648,1290.046875,216,49,136.34520759999998,545.970459,119,3340924,64515292,1189761
12323,1,-676,3272,642.1433227000001,337383.3181,580.8470695,3948,147,2294,1065.043676,79717.40234,2147,-1039,292.1006087,71505.4978,1524,26390275,72596354,5460657
12324,1,-676,2020,496.45724580000007,176716.0349,420.37606370000003,2696,-49,1568,1051.827242,109619.1052,1617,-940,283.8325871,68184.375,1880,15774067,70805795,5155900
12325,1,-40,909,299.6850691,19826.09155,140.80515459999998,949,245,1539,1035.145982,61345.16577000001,1294,-198,157.1084418,12917.592770000001,821,5747913,68577741,1579716
12326,1,-585,2696,468.71426529999997,130030.2461,360.59706889999995,3281,421,2107,1055.3790490000001,52924.9375,1686,-762,208.3830607,35607.83496,1593,14060356,71284796,2779104
12327,1,-151,898,304.3549275,23174.96655,152.2332636,1049,382,1519,1007.0053839999999,40199.256839999995,1137,-475,222.9866518,42189.349369999996,1158,5928443,64899830,3182275
12328,1,242,292,265.84288119999997,132.39746090000003,11.50640956,50,980,1019,1002.7247960000001,106.126709,39,29,56.75385449,151.14746090000003,50,4523036,64349249,206144
12329,1,202,444,267.7843115,1929.913086,43.93077607,242,794,1127,1001.852308,4176.741943,333,-138,57.59584403,1996.413086,217,4589340,64237315,212306
12330,1,232,303,262.68151459999996,185.532959,13.62104838,71,970,1049,1008.4992179999999,219.01928709999999,79,-19,31.26974376,337.86499019999997,78,4416101,65092523,62579
12331,1,212,383,286.3987332,594.2614746,24.37747884,171,843,1088,991.3403174,2098.670898,245,-89,27.17305651,602.5068359,148,5249551,62896360,47256
12332,1,232,343,274.8813949,415.265625,20.37806725,111,882,1068,1002.722583,1041.474365,186,-9,52.30036448,533.6657715,98,4835826,64348965,175061
12333,1,242,313,276.69946469999996,213.9960938,14.62860532,71,950,1039,1001.2584820000001,235.99584959999999,89,-9,26.10764974,188.63061519999997,68,4900006,64161187,43623
12334,1,242,292,268.4334182,98.4375,9.921567416,50,970,1029,1001.562716,125.625,59,-19,27.35730021,211.48608399999998,68,4611616,64200184,47899
12335,1,-1575,2707,493.9478243,170704.2712,413.16373419999996,4282,254,2235,1020.764167,45050.84155,1981,-1366,211.3853856,42037.96484,1742,15615005,66685407,2859762
12336,1,-1090,2242,553.1392795,233400.1719,483.115071,3332,274,1754,1049.789912,67165.92749,1480,-1326,289.87200839999997,73717.18652,1890,19581636,70531767,5377650
12337,1,-1292,3121,651.8769415,323431.613,568.7104826000001,4413,274,2264,1033.324474,85182.90625,1990,-405,148.49058259999998,16146.89233,751,27196387,68336606,1411165
12338,1,161,424,250.3900395,1446.6560060000002,38.03493139,263,794,1215,1009.323265,4023.5017090000006,421,-29,90.29690609,912.5849608999999,187,4012491,65198941,521826
12339,1,222,272,237.5952441,134.2773438,11.58781014,50,980,1039,1008.3244300000001,150.09375,59,69,98.87413084,196.578125,59,3612896,65069962,625670
12340,1,161,252,215.74829810000003,261.8395996,16.18145851,91,970,1049,1011.9018679999999,212.47436519999997,79,99,125.5145659,230.30371090000003,69,2979029,65532505,1008250
12341,1,161,272,227.3237642,303.0380859,17.40798914,111,980,1049,1009.7502939999999,189.91308590000003,69,79,109.36921409999998,216.484375,59,3307270,65254122,765544
12342,1,131,272,219.1461057,357.845459,18.91680361,141,980,1058,1012.037001,233.00952149999998,78,89,129.0314884,249.1210938,69,3073601,65550009,1065544
12343,1,-545,2292,439.4320375,161633.0818,402.03616969999996,2837,-245,2372,1058.8570339999999,123302.0898,2617,-1099,235.2019412,39432.13843,1514,12358433,71755406,3540477
12344,1,-858,2484,586.1234005,267321.5095,517.0314396000001,3342,-225,2431,1065.179108,100508.21,2656,-1306,263.3089025,62388.001710000004,1741,21986601,72614818,4437221
12345,1,20,474,249.7767441,5050.622803,71.06773391,454,627,1372,1021.851758,16460.27319,745,-89,118.3271419,5771.420897999999,405,3992859,66827585,896084
12346,1,191,292,223.21248280000003,428.75,20.70627924,101,931,1068,1014.3846189999999,590.0224609,137,29,98.15453377,364.2333984,109,3188724,65854474,616596
12347,1,191,323,227.03427599999998,383.7773438,19.59023593,132,911,1078,1012.480231,782.4599609,167,-9,94.60964208,524.3181152,157,3298852,65607438,572863
12348,1,151,787,342.03163689999997,9923.755615,99.61804864,636,460,1205,982.5959956,23472.9939,745,-247,95.22530848,8996.404053,464,7487081,61791673,580343
12349,1,-727,3191,662.9757726,363153.7344,602.6223812000001,3918,186,2686,1088.231528,134359.449,2500,-1554,410.7141836,161658.9861,2157,28130360,75791863,10795913
12350,1,-808,3191,607.0548137,310170.6541,556.9296671,3999,196,2372,1045.267497,57627.626710000004,2176,-1089,220.1741853,31580.73413,1554,23584995,69925385,3102507
12351,1,-585,1808,359.5530211,104991.1006,324.0233025,2393,637,1911,1029.451614,29164.964839999997,1274,-1445,300.1868689,50448.944339999995,1940,8273816,67825320,5767178
12352,1,-353,464,211.8657446,32371.07813,179.9196435,817,843,1235,1022.109568,6155.897461,392,-792,240.1505387,24605.131840000002,1435,2872774,66861310,3691026
12353,1,-1222,3616,624.0671163,320035.7498,565.7170227000001,4838,127,1823,1039.0505660000001,68564.40601,1696,-445,160.7104345,23035.381840000002,969,24925425,69096069,1652982
12354,1,-1333,3464,946.0942821000001,813396.6736,901.8850667000002,4797,19,1705,1083.397831,164385.283,1686,-584,263.4510154,63790.80859,1247,57286041,75120055,4442012
12355,1,-1232,1414,436.5049398,94920.32715,308.09142660000003,2646,-49,1490,1024.704363,104445.1162,1539,-574,218.3834071,46924.71484,1415,12194340,67201218,3052244
12356,1,-353,2616,623.1914207000001,242359.9724,492.3006931,2969,-98,1725,1009.0646039999999,140476.6094,1823,-623,196.5436497,27386.78027,870,24855523,65165528,2472282
12357,1,-1464,3646,727.9832051,355640.2498,596.355808,5110,-137,2156,1043.504574,193009.9685,2293,-514,201.52748730000002,33117.5564,1058,33917411,69689715,2599253
12358,1,-2606,4131,1045.3174080000001,970723.8357,985.2531835000001,6737,-637,3225,1206.415695,441547.1658,3862,-1039,269.3008889,71896.40527,1741,69932063,93148085,4641470
12359,1,-1717,5101,719.3824717,460083.5115,678.294561,6818,19,2823,1083.086223,122546.8572,2804,-1564,343.6063791,102712.585,3306,33120713,75076849,7556182
12360,1,-2818,4959,970.882725,861717.4626,928.2873814999999,7777,-1401,4156,1154.759972,348724.4756,5557,-673,300.7523898,77858.95215,1544,60327249,85342118,5788928
12361,1,0,616,319.8256849,9872.46875,99.36029765,616,519,1264,998.8344457000001,28676.10938,745,-178,75.13529464,5081.25,356,6546462,63850896,361300
12362,1,141,565,323.25565539999997,8723.311523,93.39866982,424,568,1411,1007.1309960000001,34089.08984,843,-148,60.01028558,3116.5466309999997,316,6687630,64916022,230479
12363,1,-1373,2505,451.0565548,148688.7029,385.6017413,3878,107,2294,1068.7348980000002,95345.56934,2187,-1049,169.5342425,27544.050539999997,1286,13020929,73100434,1839479
12364,1,-2404,5111,763.227573,530951.8533,728.6644312000001,7515,-1578,4176,1152.674634,295450.0928,5754,-415,361.8496753,115466.0469,2979,37281045,85034164,8379852
12365,1,-1606,5111,762.545306,527940.9531,726.5954536,6717,-774,2676,1038.983285,136007.9392,3450,-396,366.7488071,106186.1084,2881,37214422,69087121,8608300
12366,1,-1323,5010,775.6362006,522272.4705,722.6842121000001,6333,-196,2107,1042.7624970000002,89165.30371000001,2303,-554,272.6570075,58934.828129999994,1841,38503137,69590632,4757878
12367,1,-868,969,379.02422,103415.23800000001,321.582397,1837,647,1441,1081.115859,32055.714839999997,794,-247,305.7677325,60698.95996,1118,9194199,74803936,5983610
12368,1,-666,989,278.4457981,38389.913089999995,195.93344040000002,1655,588,1921,1089.686609,58842.663089999995,1333,-1485,364.1653771,102149.8103,2207,4962052,75994682,8487451
12369,1,-1696,1434,439.29168839999994,129630.5898,360.0424834,3130,-107,2372,1048.5185529999999,127380.0225,2479,-425,153.440695,21841.195069999998,880,12350540,70361034,1506819
12370,1,-1282,4060,598.2199767999999,288030.8201,536.6850287,5342,29,1813,1053.757458,81638.32715,1784,-811,211.80924500000003,34605.26465,1731,22903497,71065906,2871242
12371,1,-2666,3505,689.8530641,438030.5225,661.8387435,6171,-2833,4784,1282.153681,603263.0469,7617,-2544,371.17269819999996,132809.9314,2959,30457424,105210756,8817227
12372,1,-4575,5121,908.6380433,816633.6836,903.6778649,9696,-4774,4588,1293.858758,826146.0486,9362,-1000,658.0615948,388813.7148,5683,52839878,107140511,27714884
12373,1,-3323,5131,1237.3903990000001,1417502.804,1190.589267,8454,-3392,4774,1551.436784,1309634.374,8166,-1356,343.3780715,108505.5615,2019,97992640,154045190,7546144
12374,1,-1232,2676,530.7126547,218615.697,467.5635754,3908,411,1529,1035.358551,46969.27515,1118,-247,189.9525023,24019.736080000002,1048,18025979,68605909,2309245
12375,1,-2575,3070,757.4568882,526257.8037,725.4362851,5645,313,2392,1055.3157410000001,100271.5898,2079,-1089,264.19754680000005,61456.663089999995,1702,36719420,71276244,4467222
12376,1,-2525,4979,1009.963056,941974.9844,970.5539574999999,7504,-666,3166,1172.626659,315311.7148,3832,-1930,412.1320518,167577.24,2405,65281624,88003410,10870581
12377,1,-1353,5090,707.4274146,468518.74,684.4842876,6443,-1333,2882,1121.521567,239666.5615,4215,-1386,286.36850710000004,60255.28101,2346,32029027,80499880,5248443
12378,1,-5000,5151,1215.049555,1410705.381,1187.73119,10151,-4911,4745,1501.247252,1270980.882,9656,-2871,593.9080842,332819.3662,4672,94486107,144239572,22574516
12379,1,-1232,5111,791.7401227000001,597616.7654,773.0567672000001,6343,-2441,4637,1319.242201,811555.8044,7078,-1099,359.6302789,99068.81152,1980,40118555,111385599,8277372
12380,1,-3404,5131,1116.028603,1169963.578,1081.6485460000001,8535,-4911,4784,1564.121174,1468075.871,9695,-2237,471.83680310000005,203594.5928,3306,79713270,156574403,14248318
12381,1,-1494,5101,788.1556299,601959.4079999999,775.8604307,6595,-3666,4715,1324.232779,816780.1912,8381,-1514,385.9822089,115223.9451,2108,39756115,112229917,9534865
12382,1,-1363,4979,1042.926606,926041.6523,962.3105800000001,6342,-176,3372,1224.191557,345168.9688,3548,-2633,650.9679572000001,419207.249,3840,69612538,95913278,27120594
12383,1,-1212,2303,463.34132939999995,172711.4219,415.5856372,3515,372,2225,1040.84286,81947.11499,1853,-1920,509.6797095,241311.3906,3217,13739852,69334647,16625498
12384,1,-4010,5070,1068.51708,1103691.562,1050.567257,9080,-2764,4029,1212.774138,509655.3318,6793,-2297,437.37030219999997,166761.3906,3544,73070640,94132551,12242738
12385,1,-898,4909,688.4017609,433903.2341,658.7133171,5807,-401,4186,1141.01998,252198.2773,4587,-2891,490.13367120000004,227982.7517,3504,30329407,83323302,15374785
12386,1,-4949,5151,982.407335,937417.5291,968.2032478,10100,-4892,4774,1404.418607,1070188.476,9666,-4920,1028.534189,1045187.627,9593,61767947,126233064,67704485
12387,1,-717,2232,538.9037194,192350.3818,438.5776805,2949,-78,2323,1099.7866199999999,147052.8357,2401,-1069,270.6189953,72958.76929,1474,18586702,77409959,4687017
12388,1,-2060,1676,437.27478130000003,138560.4978,372.2371526,3736,176,2205,1033.357868,40361.16772,2029,-217,164.1209063,5733.581787,672,12237391,68341023,1723883
12389,1,-767,878,369.8764785,70799.75952,266.082242,1645,480,1431,1032.526203,38072.79077,951,-712,151.8596186,23048.65234,969,8755751,68231063,1475926
12390,1,-90,676,176.9162054,9616.78125,98.06518878,766,960,1245,1025.6347119999998,1429.6835939999999,285,0,182.9295886,2228.195068,277,2003158,67323300,2141647
12391,1,-757,3353,671.26385,312490.0156,559.008064,4110,166,1901,1023.4953210000001,116227.2009,1735,-475,181.82550869999997,31421.531010000002,1148,28838090,67042731,2115873
12392,1,-1686,727,414.37134239999995,89343.57788,298.903961,2413,264,2009,1045.616505,77753.8125,1745,-514,162.5525396,26328.570069999998,959,10989031,69972088,1691093
12393,1,-212,2191,457.7867442,78264.38647,279.7577282,2403,-137,1823,1050.525018,156752.1836,1960,-514,176.16070430000002,26049.11621,870,13412397,70630580,1986086
12394,1,-2060,3303,671.5602402000001,377246.9648,614.2043348,5363,-333,2068,1042.724459,245554.0603,2401,-792,187.3686623,35098.109130000004,1168,28863562,69585555,2246849
12395,1,-2797,5030,1113.672683,1178312.522,1085.501047,7827,-1029,4117,1213.026297,458421.9998,5146,-1257,363.44093399999997,120700.4209,2068,79377078,94171699,8453716
12396,1,-2737,5060,796.7900151,561272.3337,749.1811088,7797,-156,2843,1097.384789,223534.5273,2999,-732,333.8443687,101620.1006,2840,40631957,77072216,7132932
12397,1,-808,2626,543.4736222999999,197912.2986,444.8733512,3434,-58,2598,1072.4291640000001,202341.2178,2656,-465,201.756157,40526.23804,1286,18903269,73606676,2605155
12398,1,-1343,3606,645.6522381,305394.2969,552.6249152,4949,88,2176,1044.134121,208201.6006,2088,-554,184.4894983,33896.83984,979,26679476,69773828,2178328
12399,1,-1434,2616,613.5956654,231540.9763,481.1870492,4050,-147,2137,1083.04528,269210.0642,2284,-495,189.426107,35163.33984,970,24095977,75071173,2296464
12400,1,151,929,423.4142291,22772.83179,150.9066989,778,-156,1803,1051.3941929999999,174687.1875,1959,-425,157.22018799999998,23143.08984,623,11473895,70747504,1581964
12401,1,-1505,4121,783.6520772000001,495225.6931,703.7227387999999,5626,-107,2009,1076.4170960000001,177614.4685,2116,-1168,310.8469026,95056.89429,2029,39303077,74155121,6184051
12402,1,80,1343,434.56670230000003,46742.780269999996,216.2007869,1263,-49,1598,1026.254134,117957.44699999999,1647,-415,176.63225390000002,31084.39624,900,12086286,67404643,1996733
12403,1,-2727,5121,931.5529960000001,743897.9841,862.4952082000001,7848,-2568,4588,1214.970775,611457.4099,7156,-366,216.67004,41311.52734,1573,55538623,94473855,3004538
12404,1,-1585,1444,491.2910447,184178.6521,429.16040369999996,3029,343,1588,1108.8006890000001,73007.57813,1245,-920,373.5615327,93215.65625,2048,15447481,78684094,8931086
12405,1,101,505,289.63204029999997,5311.621094,72.88086919,404,656,1235,1018.5320630000001,16802.5,579,-247,98.25524795,9525.413086,534,5368750,66394084,617862
12406,1,181,515,329.7687874,4791.587646,69.22129475,334,656,1264,1003.591714,19129.26538,608,-346,114.4389166,9962.015381000001,524,6959837,64460565,838161
12407,1,-1959,2919,676.1386345,358380.9275,598.6492525,4878,39,1990,1081.068532,182256.7244,1951,-841,206.9631987,40934.71265,1108,29258461,74797387,2741361
12408,1,-1616,3242,677.0887474,381815.3611,617.9120982000001,4858,-1078,2931,1108.658853,367505.3982,4009,-653,284.2759993,72952.91309,1940,29340747,78663965,5172022
12409,1,-1323,2929,480.34120360000003,197700.2888,444.6350063,4252,254,3127,1075.853745,109461.2021,2873,-1752,307.42483839999994,80659.68359,2445,14766571,74077522,6048642
12410,1,-2151,4000,730.0784204,473356.4375,688.0090388,6151,-88,2735,1081.322057,122376.7048,2823,-1564,337.3888937,101817.0505,2395,34112928,74832473,7285201
12411,1,-303,1949,358.1408373,81737.02124,285.89687169999996,2252,490,1450,1032.349633,27289.232180000003,960,-19,121.0080705,3009.30835,217,8208951,68207729,937149
12412,1,-393,2959,496.135267,211942.5447,460.3721806,3352,0,1862,1054.410558,87637.625,1862,-297,242.6370747,45690.83984,1227,15753613,71154024,3767856
12413,1,-10,505,242.6521108,6717.769287,81.96199904,515,549,1245,1016.6956970000001,13601.70288,696,-257,141.0260947,10452.05835,544,3768323,66154889,1272855
12414,1,-242,636,244.8736281,12792.68359,113.10474609999999,878,470,1274,1012.9852699999999,17495.55859,804,-227,139.8909732,11959.64819,702,3837638,65672906,1252447
12415,1,-353,3212,457.85747649999996,160127.2188,400.1589918,3565,411,2656,1043.403722,62364.04077000001,2245,-1118,250.98997740000001,44414.87109,1751,13416542,69676245,4031742
12416,1,-1181,2848,621.1498662,327142.0938,571.9633675,4029,343,2029,1108.760886,85487.03101,1686,-950,320.57004889999996,80171.30859,1643,24692938,78678445,6576970
12417,1,-939,2616,642.0143958,300198.1365,547.9034007,3555,147,1666,995.1040775,91705.86621000001,1519,-405,184.7979894,33698.07007,989,26379679,63374856,2185619
12418,1,-1757,3616,888.7596606000001,650379.8123,806.4612900000001,5373,-215,2166,1049.746725,174659.37399999998,2381,-920,325.70356539999995,96107.79688,1959,50553199,70525964,6789300
12419,1,-1747,4111,1031.533105,902242.9138,949.8646818,5858,-568,2588,1127.7324800000001,312390.906,3156,-910,325.2050555,105561.8904,2335,68099875,81393955,6768533
12420,1,-1111,2202,587.5918146,286207.5466,534.9836882000001,3313,264,1666,1087.401849,71856.13184,1402,-881,298.7037883,66257.4978,1722,22096905,75676338,5710333
12421,2,-2929,1141,706.5031293999999,350066.2224,591.6639438,4070,352,1441,974.8693902999998,81775.45288,1089,-574,440.52529010000006,78100.99902,2385,31945387,60823701,12420002
12422,2,-5010,2232,1329.869143,1706192.483,1306.213031,7242,-1764,4598,1456.253707,1212376.513,6362,-2821,664.3553737000001,388998.6006,4296,113187324,135723191,28247556
12423,2,-4979,2565,1435.579141,1894576.4340000001,1376.436135,7544,-1058,4696,1139.724974,627264.7126,5754,-1019,636.6748213,213524.5154,3246,131896798,83134273,25942709
12424,2,-4939,1454,904.4799265,719546.8037,848.2610469,6393,49,2598,1071.037931,232588.6523,2549,-2079,679.5367908,349377.6875,5663,52357372,73415824,29553296
12425,2,-3909,616,580.358631,297420.0935,545.3623506,4525,490,2147,989.6697366000001,41030.1709,1657,-742,391.84467589999997,35507.05859,1583,21556233,62684556,9826704
12426,2,-4989,2474,1143.260906,1086145.5,1042.183045,7463,-843,2558,1078.768511,239619.7773,3401,-1653,473.35611919999997,139721.1501,3088,83650912,74479456,14340225
12427,2,-1151,787,361.8498912,90471.50684,300.7848182,1938,578,1892,958.1534895,38302.04468,1314,-584,473.0628592,78913.07813,1920,8379862,58755719,14322462
12428,2,-2292,1272,514.1542813,192564.1211,438.82128610000007,3564,392,2166,1011.1176130000001,117155.2439,1774,-861,467.49418449999996,103693.3662,2158,16918696,65430965,13987252
12429,2,-2141,434,568.7286672,173283.9373,416.27387289999996,2575,-303,2735,1034.716401,265300.0537,3038,-930,452.33772989999994,116502.4861,1870,20700947,68520834,13095003
12430,2,-737,898,377.68834289999995,88235.63257,297.04483260000006,1635,549,2196,978.8213814999999,58705.792720000005,1647,-603,395.15495380000004,43880.55859,1315,9129503,61317843,9993436
12431,2,-4000,1585,724.9036251,436541.5232,660.7128901000001,5585,-19,3166,1006.774141,224467.3142,3185,-2207,541.9397885,182903.3708,3791,33631057,64870027,18796719
12432,2,-2373,414,597.1376516,223508.0146,472.7663426,2787,-68,2107,1071.1331619999999,204970.6875,2175,-1227,456.8986998,106166.3337,2444,22820696,73428880,13360411
12433,2,-3707,474,861.2942931,596750.1912,772.4960784,4181,-9,2333,997.6999095000001,140155.8494,2342,-1366,412.11110460000003,74354.5625,2148,47476983,63705927,10869476
12434,2,-4070,2636,856.2245069,628205.1475,792.593936,6706,284,2333,989.1774597000001,107953.8904,2049,-762,454.1462285,78721.69116,1831,46919706,62622211,13199923
12435,2,-5000,1929,1200.339301,1354983.749,1164.0376919999999,6929,-1019,2882,1142.844136,467380.1836,3901,-564,636.2173616,266899.5586,3920,92212124,83589934,25905442
12436,2,-646,20,307.3762708,18726.21069,136.8437455,666,656,1235,949.2217124,7553.835693000001,579,39,358.05079950000004,10615.67871,495,6046731,57665399,8204824
12437,2,-4353,2343,1173.7076539999998,1182391.371,1087.3782099999999,6696,-372,2480,1111.50116,322842.7087,2852,-1445,537.9713776000001,192876.7712,2900,88165738,79067829,18522445
12438,2,-4989,1767,1010.766031,851955.4648,923.0143362,6756,117,1872,1036.823439,117724.0537,1755,-1435,485.6622733,145530.0273,2514,65385470,68800182,15095542
12439,2,-2232,525,512.1966480000001,153878.1006,392.27299239999996,2757,352,1352,958.7055073999999,42903.24609,1000,-1257,450.15160639999993,147087.8711,2177,16790106,58823440,12968734
12440,2,-1838,1303,583.8568826000001,242263.4197,492.20262060000005,3141,323,2588,1029.997042,121569.4961,2265,-1287,419.139483,147997.2656,2187,21816887,67897210,11243386
12441,2,-1090,545,387.90869580000003,98103.69434,313.21509280000004,1635,539,1392,1013.9666460000001,31843.6521,853,-564,252.0154695,39684.98022,1167,9630282,65800215,4064755
12442,2,-1242,131,443.74190130000005,94106.48438,306.76780210000004,1373,294,1666,1000.957581,45829.349369999996,1372,-346,237.36404,30340.125,860,12602040,64122629,3605868
12443,2,-3020,1292,583.6978296,282002.9521,531.0395014999999,4312,372,1656,1021.722351,60100.546879999994,1284,-1019,301.2427126,63113.30444,1613,21805002,66810660,5807819
12444,2,-2464,2616,958.3990882999999,673441.9336,820.6350794,5080,156,2205,1235.876024,215827.7732,2049,-1059,565.7400021000001,306041.71,3128,58785844,97752931,20483952
12445,2,-3070,4888,1191.669975,1311228.885,1145.089029,7958,-1107,2509,1301.091147,401525.5427,3616,-3930,884.7955537,760424.0681,5632,90884949,108341643,50103243
12446,2,-4343,4222,1202.579656,1334318.031,1155.1268460000001,8565,-294,3343,1254.34389,370380.9336,3637,-4950,999.7833906,965555.4001,7019,92556661,100696230,63972277
12447,2,-2101,1868,767.620583,524653.9021,724.3299677,3969,568,2186,1157.691345,117704.4023,1618,-1594,580.7846927999999,298753.8552,3613,37711447,85775952,21587895
12448,2,-4383,1878,1103.193086,1165569.808,1079.615584,6261,-696,4343,1267.594209,602258.6951,5039,-1782,798.3681207999999,569074.7656,4395,77890239,102834885,40793066
12449,2,-4686,3747,1098.6203,1135677.563,1065.681736,8433,-450,2617,1325.292992,471614.6873,3067,-3742,797.4771352999999,571691.6865,6672,77245860,112409697,40702066
12450,2,-5000,2252,978.9219037999999,931576.2773,965.1819918,7252,39,2225,1118.46831,169078.8396,2186,-960,574.4362862,159859.4666,2524,61330438,80062167,21118531
12451,2,-4989,1272,1217.6812619999998,1409475.9340000001,1187.213516,6261,-696,2480,1065.11454,314736.8005,3176,-1425,768.1567121,501176.9021,4276,94895850,72606015,37764143
12452,2,-3464,2555,774.5001311000001,573934.4841,757.5846382999999,6019,-313,2294,1215.774425,280485.0115,2607,-613,343.4160196,55043.32715,1414,38390429,94598877,7547812
12453,2,-3414,3191,1193.455396,1318141.2659999998,1148.103334,6605,284,2666,1100.930061,142373.9375,2382,-1584,594.5577006,203669.3845,3118,91157490,77571008,22623927
12454,2,-4505,2131,1065.817453,1052337.4340000001,1025.834993,6636,117,2274,1163.718353,180403.5898,2157,-445,337.21202989999995,53847.626710000004,1316,72701878,86671386,7277565
12455,2,-4353,1464,718.6880517000001,483257.57399999996,695.1672993,5817,274,1509,1033.7917539999999,64251.64819,1235,-1346,524.4489518999999,207373.5583,2969,33056801,68398425,17602989
12456,2,-3666,1141,1018.377808,944192.2244,971.695541,4807,176,2568,1061.627539,149982.5615,2392,-594,410.5698974,85902.40601,1821,66373975,72131394,10788329
12457,2,-1525,878,307.3486162,82660.38647,287.5071938,2403,460,1500,1035.2363480000001,32939.286869999996,1040,-1425,502.5835285,182902.4529,3098,6045643,68589715,16165773
12458,2,-2070,1323,613.0605216,334054.9001,577.9748266,3393,617,1990,1074.6103,59069.02319,1373,-2405,620.8565152000001,348550.7969,3761,24053965,73906387,24669620
12459,2,-1000,1626,384.8412213,128279.0056,358.16058639999994,2626,509,2058,1041.0203900000001,74357.87671,1549,-1910,567.4839067,241585.9802,2850,9478577,69358301,20610431
12460,2,-3858,1585,1030.614812,1015436.6109999999,1007.688747,5443,-117,2588,1202.007234,249523.3337,2705,-1128,471.28260830000005,130118.3025,2484,67978681,92468569,14214867
12461,2,-2303,848,479.82977120000004,187600.8123,433.1290942,3151,382,1931,1018.472178,73483.19507,1549,-1405,500.80162300000006,167452.7712,3187,14735143,66386277,16051345
12462,2,-606,545,251.2302542,20687.07788,143.83003119999998,1151,833,1068,979.9975606,2688.328125,235,-29,287.3114599,9951.308594,514,4039465,61465294,5283064
12463,2,-2080,686,468.37750199999994,200970.6267,448.2974757,2766,225,1990,1039.913841,55283.45288,1765,-653,347.68064100000004,62340.51342999999,1653,14040159,69210931,7736437
12464,2,-535,313,220.5987945,29744.6853,172.4664759,848,735,1480,997.4566093000001,18713.93652,745,-504,330.0342785,55359.30859,1187,3114485,63674860,6971048
12465,2,-3121,939,602.7811066,322717.6211,568.082407,4060,225,2147,1058.403648,111072.4648,1922,-495,373.680721,84968.99609,1633,23254084,71693970,8936786
12466,2,-757,494,260.137764,44577.155269999996,211.13302740000003,1251,774,1784,1056.3203529999998,26789.99609,1010,-920,403.2003224,102713.8193,2028,4330986,71412012,10404512
12467,2,-434,181,189.9680483,15022.05835,122.56450690000001,615,803,1333,1014.7041830000001,9556.140381000001,530,-227,306.3723225,21553.42871,751,2309623,65895973,6007296
12468,2,-1898,1303,482.3344761,232323.1091,481.9990759,3201,137,2098,1079.44006,126893.5303,1961,-1673,629.0010432999999,349578.4219,3415,14889379,74572214,25321108
12469,2,-4939,5151,1357.2518710000002,1808866.301,1344.941003,10090,-4098,4117,1814.98292,2038852.835,8215,-1415,525.0618267,255334.658,2355,117896489,210826432,17644155
12470,2,-646,959,283.924038,78904.84546,280.9000631,1605,519,1558,1020.2402369999999,28319.632569999998,1039,-415,402.9719477,81579.44507,1949,5159223,66616969,10392729
12471,2,-5000,5161,1436.484418,2063276.781,1436.411077,10161,-3411,4588,1692.3658,1862288.679,7999,-2366,536.9166311,230829.3711,3465,132063199,183302528,18449886
12472,2,-636,535,246.7354986,20865.90527,144.4503557,1171,578,1382,983.980405,12772.280270000001,804,-49,329.91689289999994,16048.765630000002,1009,3896218,61965916,6966090
12473,2,-161,818,350.52144189999996,50201.33984,224.05655499999997,979,245,1529,1018.597435,52515.49976,1284,-574,251.9843435,56516.02905,1158,7863378,66402607,4063751
12474,2,-3101,5121,1485.86685,2181073.156,1476.845678,8222,-803,4009,1399.887334,781272.5291,4812,-2168,826.4524997999999,638430.1736,4474,141299219,125419811,43713519
12475,2,-80,232,92.29622825,2565.506836,50.65083253,312,892,1058,998.2920727,1019.6396480000001,166,217,303.371369,1583.625,218,545190,63781572,5890188
12476,2,-3161,4909,1240.084901,1494858.0,1222.643857,8070,-676,2147,1176.876786,398058.8115,2823,-524,390.32178230000005,106421.2461,1731,98419876,88642494,9750470
12477,2,-1404,3040,650.4784297,367249.0469,606.0107647000001,4444,-470,1656,1130.379389,265470.0469,2126,-554,329.3841792,70773.01465,1217,27079820,81776484,6943612
12478,2,-1404,5161,1542.895659,2213488.7709999997,1487.779813,6565,-3137,4794,1712.487181,1756878.746,7931,-1980,700.2434509999999,428207.5388,4049,152353729,187687190,31381817
12479,2,-131,828,300.8366978,32992.68359,181.6388824,959,450,1352,1003.841909,28186.30249,902,-287,220.65205219999999,18209.8064,762,5792174,64492709,3115989
12480,2,-3121,4898,1072.245723,1065129.892,1032.051303,8019,19,1843,1016.7364230000001,93246.97437000001,1824,-920,343.14200780000004,74664.24609,2217,73581497,66160189,7535772
12481,2,-1474,5161,1433.0073869999999,1929749.131,1389.154106,6635,-1941,3176,1328.873636,629982.1619,5117,-841,366.39587539999997,98807.875,2177,131424651,113017929,8591740
12482,2,-1474,4979,810.122917,621859.9001,788.5809408,6453,-980,2058,1138.485034,337309.4119,3038,-574,334.2193095,77263.3064,1267,42003145,82953483,7148963
12483,2,-666,2555,418.0793697,170656.2712,413.1056417,3221,274,2401,1046.73558,96217.7959,2127,-128,286.3409517,19280.02515,702,11186583,70121944,5247433
12484,2,-4060,5131,912.1388582999999,789180.6345,888.3583931,9191,-941,2598,1102.1747890000001,222679.8884,3539,-514,273.8395972,33664.8584,1454,53247827,77746513,4799240
12485,2,-343,121,94.86248271,7919.1521,88.98961793,464,833,1107,1010.9405039999999,2689.613037,274,-247,283.1882104,19279.15234,751,575929,65408045,5132516
12486,2,-595,727,244.47612999999998,31286.741939999996,176.88058669999998,1322,480,1411,987.0306638000001,13339.46875,931,-227,357.9254025,28096.53125,1197,3825189,62350690,8199078
12487,2,-353,191,134.51754069999998,10981.10059,104.7907467,544,696,1156,1007.1566650000001,5752.33374,460,29,301.7333001,11615.89233,426,1158078,64919331,5826751
12488,2,-282,2212,396.0180709,128184.75,358.0289793,2494,-98,1500,1063.5349,89462.98804,1598,-237,247.3358357,23314.3689,771,10037140,72390815,3915201
12489,2,-3515,4979,823.5251116000001,666350.0486,816.3026697,8494,-107,2313,1114.2629359999999,187911.7185,2420,-217,265.48922999999996,15450.30371,702,43404391,79461241,4511010
12490,2,-717,3737,635.1893418999999,383407.8594,619.1993697,4454,-9,1705,1090.221351,164565.0898,1714,-316,327.0799788,39559.944339999995,1167,25821792,76069286,6846804
12491,2,-3535,5101,1257.171217,1533009.9530000002,1238.147791,8636,-421,2607,1171.5956,348745.2344,3028,-950,362.98659150000003,107496.3357,2306,101150686,87848720,8432593
12492,2,-3212,5101,1146.1672820000001,1277122.875,1130.0986130000001,8313,-441,2343,1173.5678369999998,229149.2188,2784,-871,317.0641447,69811.63257,1474,84076764,88144734,6433899
12493,2,-2787,4979,839.6046875,664371.5537,815.0899052999999,7766,147,2303,1099.9281230000001,150035.9678,2156,-940,299.2056933,64267.88452000001,1355,45115906,77429880,5729539
12494,2,-2717,4313,1097.6785300000001,1114860.652,1055.869619,7030,-480,2137,1141.213211,169473.4531,2617,-762,283.16848450000003,50938.046630000004,1276,77113482,83351526,5131801
12495,2,-3838,4434,968.7398306,904939.2595,951.2829545,8272,-245,2980,1167.38708,260620.6943,3225,-1653,391.3599885,114014.3083,2336,60061239,87218726,9802409
12496,2,-1737,5101,805.6265225,637071.2031,798.1674029,6838,-68,1745,1132.189686,191558.5798,1813,-653,318.9106213,45201.208739999995,1286,41538182,82038623,6509055
12497,2,-3797,5121,1309.92637,1635428.496,1278.8387300000002,8918,-480,2176,1174.094678,276720.0693,2656,-1079,480.12249410000004,195857.6423,3098,109818054,88223892,14753127
12498,2,-3565,5070,1206.933608,1397647.3280000002,1182.221353,8635,-921,2117,1231.391559,483275.2693,3038,-1059,430.0972637,150608.1787,2435,93228079,97044811,11838954
12499,2,-1303,3676,707.4819234,462694.3435,680.2163946000001,4979,-598,2196,1119.988267,177189.2031,2794,-811,288.4442375,37651.1814,1533,32033963,80279918,5324805
12500,2,-2626,5060,1093.6032619999999,1146767.3090000001,1070.8722189999999,7686,-1147,1892,1166.2821,358275.499,3039,-831,337.7254571,70592.74976,1395,76541958,87053692,7299743
12501,2,30,101,70.41184648,164.42944340000003,12.82300446,71,980,1029,1001.25845,110.7868652,49,257,293.9139968,169.796875,59,317301,64161183,5528668
12502,2,-1383,2212,444.7718868,185715.1553,430.94681260000004,3595,-19,1892,1077.788143,101177.8584,1911,-247,276.1716518,24826.87109,751,12660610,74344146,4881330
12503,2,-2111,4565,697.5728457,425861.0303,652.5802865,6676,-803,1990,1108.7709619999998,202412.488,2793,-475,219.5121366,22219.2771,950,31142904,78679875,3083877
12504,2,-5010,5161,1768.824036,2997603.953,1731.35899,10171,-3480,4166,1846.748566,2484464.99,7646,-2653,680.7762342999999,461810.9648,4157,200239262,218270737,29661202
12505,2,-1676,1454,458.5306015,190816.21,436.82514800000007,3130,-88,2176,1099.4883539999998,176523.3884,2264,-465,309.595906,55184.381839999995,1613,13456020,77367977,6134376
12506,2,202,262,232.6973625,251.53808590000003,15.85995227,60,980,1039,1004.7472630000001,182.88183590000003,59,108,130.7213162,261.1083984,80,3465476,64609092,1093636
12507,2,80,171,128.5083898,448.84375,21.18593283,91,960,1039,1006.904717,217.16186519999997,79,207,237.73987889999998,203.0273438,60,1056922,64886855,3617296
12508,2,-848,2151,398.5391096,141156.8884,375.70851519999997,2999,323,1617,1036.35923,46699.83765,1294,-108,215.8614645,10502.109129999999,593,10165339,68738589,2982155
12509,2,-595,909,299.73026939999994,70277.5896,265.0992071,1504,19,1539,1087.276967,107288.2419,1520,-217,265.7572318,16367.02734,622,5749647,75658957,4520122
12510,2,-1494,5090,824.0465797999999,553681.447,744.0977402000001,6584,-607,2558,1050.175276,184415.4177,3165,-435,154.1309305,19494.70215,989,43459377,70583559,1520406
12511,2,-1010,3323,652.2828901,425187.1475,652.0637602999999,4333,-117,2058,1062.5456980000001,217903.28100000002,2175,-1207,919.9775558,690765.4353,5325,27230270,72256215,54166957
12512,2,-2111,4282,700.1858012,490252.2461,700.1801526,6393,-274,1823,1099.244769,184637.7646,2097,-1227,720.5878892999999,375960.999,5850,31376650,77333700,33231802
12513,2,-767,2151,420.8298721,177087.8193,420.81803590000004,2918,352,1450,1016.939127,52951.12109,1098,-1059,602.7306872,180901.9023,3554,11334258,66186572,23250194
12514,2,-606,2434,418.7823308,175316.3787,418.7079873,3040,127,1715,1004.200856,90864.90991,1588,-1069,615.9513221,207767.0771,4009,11224233,64538839,24281346
12515,2,-626,2808,449.545517,200925.5896,448.2472416,3434,205,1725,1036.1050109999999,91928.03125,1520,-1000,588.8357156000001,206172.8037,4356,12933835,68704870,22190560
12516,2,-262,1191,274.08150589999997,74877.01929,273.63665560000004,1453,-323,1754,1035.940914,128176.9412,2077,108,424.96753550000005,17255.131840000002,753,4807723,68683109,11558234
12517,2,-3141,1373,754.0606842999999,541418.5974,735.8115230000001,4514,49,2411,1134.6072279999998,176812.7773,2362,-861,364.9066876,83211.62476,1801,36390881,82389348,8522041
12518,2,-434,242,116.20893090000001,11835.0271,108.7889107,676,725,1107,1009.052967,2344.378662,382,148,270.3104985,3462.4860840000006,347,864289,65164025,4676337
12519,2,-4989,2111,761.2159578,572290.988,756.4991659,7100,107,4313,1116.4235099999999,226648.6111,4206,-1366,342.3177435,55351.506839999995,2029,37084783,79769693,7499612
12520,2,-727,757,273.53139100000004,68511.58765,261.7471827,1484,401,1862,1073.833801,52324.62109,1461,-554,272.2846052,18972.64063,1088,4788443,73799618,4744890
12521,2,-2878,757,698.1687318,445957.3455,667.8003785,3635,147,2950,1081.988195,149809.238,2803,-1049,388.42528639999995,85282.19116,1949,31196133,74924701,9655949
12522,2,-303,171,141.410915,8295.892334,91.08178926,474,833,1215,1021.31028,5859.746094,382,158,243.0165568,2092.782959,228,1279811,66756780,3779651
12523,2,-898,0,294.885836,34802.51563,186.5543235,898,-58,1480,1036.399281,78181.84277,1538,-603,361.33266789999993,101240.0857,1929,5565290,68743902,8355923
12524,2,-222,-10,134.43789230000002,2272.27124,47.66834631,212,921,1392,1021.457981,3804.991211,471,178,236.56744550000002,489.1865234,109,1156707,66776090,3581706
12525,2,-3454,1949,979.7407820000001,956914.9336,978.2202889,5403,-647,3627,1160.998944,324248.8669,4274,-1712,503.3833653,150253.4756,3078,61433088,86266787,16217268
12526,2,-545,1262,372.2632217,129620.1006,360.0279164,1807,735,1470,1007.522526,13819.98022,735,-306,299.2832323,32650.9314,1197,8869114,64966505,5732509
12527,2,-5000,3727,952.6639458999999,888247.5938,942.4688821000001,8727,-343,4696,1170.766482,408823.5938,5039,-3960,615.9664662,332799.1787,4950,58084390,87724426,24282540
12528,2,-5010,3565,1038.206958,1076825.547,1037.702051,8575,-352,4735,1219.65118,446638.9375,5087,-2217,559.4655374,258201.8037,3187,68983916,95203136,20032108
12529,2,-4919,3373,940.5502627999998,852554.6287,923.3388482,8292,-392,4539,1143.375007,389482.5303,4931,-2584,490.4978179,176111.7908,3534,56616627,83667610,15397639
12530,2,-555,484,189.7737551,35358.23804,188.03786330000003,1039,254,1931,1063.092607,106749.1365,1677,39,339.7835248,17229.36621,574,2304901,72330617,7388982
12531,2,-1727,1252,408.0534585,145681.5273,381.6824955,2979,598,2470,1077.5514050000002,73202.84277,1872,-1475,334.2950372,57558.78687,2148,10656488,74311490,7152203
12532,2,-4989,1464,778.9703942000001,596875.96,772.5774782999999,6453,-166,3598,1155.200923,218329.9373,3764,-910,373.292048,57237.84155,1830,38834872,85407307,8918205
12533,2,-575,1242,280.08115449999997,63815.79467999999,252.6178827,1817,862,1647,1040.866016,14246.0625,785,-2663,463.0376942,205067.5156,3306,5020509,69337732,13721850
12534,2,-878,454,278.30519439999995,70471.08984,265.46391439999996,1332,205,1823,1101.296523,107990.2656,1618,-455,267.0261574,32530.897460000004,969,4957042,77622658,4563390
12535,2,-202,-80,152.0414725,1078.279053,32.83715963,122,960,1049,996.3097222000001,305.7880859,89,247,277.4610615,281.60717769999997,59,1479463,63528516,4927017
12536,2,-4787,2252,741.5783737,536810.3376,732.6734180999999,7039,235,2705,1128.131163,189942.1228,2470,-1297,353.0051345,66712.23438,2079,35196063,81451515,7975208
12537,2,-1757,676,528.7914877000001,263799.5146,513.6141690000001,2433,88,2058,1153.059815,176138.0615,1970,-643,364.4445474,63099.07592999999,1623,17895708,85091004,8500469
12538,2,-1252,737,559.4573822000001,287332.5273,536.0340729,1989,421,1637,1131.18823,68967.9834,1216,-544,239.637291,17700.55859,940,20031524,81893556,3675266
12539,2,-343,595,217.7419631,36751.0,191.7055033,938,843,1362,1025.831759,6345.195068,519,-762,280.4155399,40278.100589999995,1365,3034340,67349171,5032504
12540,2,-606,1727,276.39574780000004,76259.83179,276.1518274,2333,598,1421,1067.880224,18589.30835,823,-613,311.36767349999997,29990.179439999996,1315,4889255,72983563,6204789
12541,2,-2707,1484,595.9388339,340266.7178,583.3238533,4191,382,1725,1107.261289,94729.42188,1343,-603,439.5833965,113727.1865,1781,22729158,78465764,12366948
12542,2,-3787,1424,708.7215712999999,494093.1873,702.9176248,5211,-323,2892,1106.1725470000001,278742.5759,3215,-1554,394.8570548,79390.70313,2494,32146321,78311533,9978374
12543,2,-1777,1232,378.1548542,135235.0781,367.7432231,3009,333,2950,1085.670876,137197.2178,2617,-1702,388.63734300000004,82501.38062000001,2602,9152070,75435600,9666495
12544,2,-4969,1282,895.9346201999999,778751.2813,882.4688557,6251,-392,3480,1179.060941,255660.1521,3872,-2049,460.6477606000001,141282.3337,3118,51372726,88971821,13580567
12545,2,-5000,2747,775.0887046,590037.3086,768.1388602000001,7747,-254,4637,1143.057864,280032.3711,4891,-1356,352.6688647,58494.876710000004,2177,38448800,83621202,7960021
12546,2,-4636,1919,767.0600429,564756.4587,751.5028002,6555,-29,3529,1143.315143,214327.9568,3558,-1019,363.2104461,59552.42163,2038,37656391,83658849,8442997
12547,2,-525,212,156.2772976,20366.49609,142.71123319999998,737,470,1313,1004.876648,12493.98022,843,-742,341.81363710000005,33225.225589999995,1494,1563046,64625733,7477540
12548,2,-5010,4858,1025.401636,1047691.209,1023.567882,9868,-1068,4813,1292.356176,573942.7654,5881,-3178,553.3917859000001,238088.8398,4197,67292705,106891807,19599518
12549,2,-3727,2686,804.7703088,637435.3037,798.3954557,6413,-666,3254,1178.824991,346836.3611,3920,-1990,528.5851693,222609.4336,3296,41449936,88936215,17881746
12550,2,-2353,2737,647.5173018999999,415266.2256,644.4115343,5090,-147,4205,1188.7628550000002,351613.2773,4352,-2227,552.1463376,240373.3884,3642,26833834,90442056,19511397
12551,2,-4868,2414,891.5448233,784515.0017,885.7285147,7282,-205,3343,1148.286135,228005.0837,3548,-1009,371.9016377,79965.9353,1622,50870539,84387907,8851893
12552,2,-4979,2434,938.4055043999999,862928.3572,928.9393722000001,7413,-549,4754,1197.5670189999998,425993.8845,5303,-3554,658.8092241,350544.7148,4563,56358713,91786673,27777894
12553,2,-4030,2262,753.1695215,561490.7029,749.3268332,6292,29,4107,1137.645327,270820.1365,4078,-3653,626.345589,320493.1716,5177,36304917,82831161,25107763
12554,2,-1090,3797,855.5695837000001,731509.7969,855.28346,4887,-254,4666,1145.88222,269073.0,4920,-584,316.46507010000005,45926.6521,1782,46847956,84034948,6409609
12555,2,-4989,2969,1012.7074630000001,1012329.835,1006.1460310000001,7958,-372,2990,1252.519804,376102.9724,3362,-584,453.23981299999997,121154.0525,2643,65636890,100403575,13147285
12556,2,-4989,1757,894.8306666000001,788803.4236,888.1460597999999,6746,-205,4147,1184.182141,269127.0938,4352,-940,370.57790589999996,76326.70288,1781,51246203,89746390,8788991
12557,2,-5000,4323,896.9251554,796042.3298,892.2120431,9323,-98,4235,1164.834128,305604.865,4333,-1633,358.075542,103686.7031,2207,51486383,86837667,8205958
12558,2,-5000,4060,860.6654947000001,733121.6211,856.2252162999998,9060,-705,4568,1188.736448,335520.5898,5273,-940,282.37917769999996,37751.42871,1484,47407686,90438038,5103232
12559,2,-1505,1383,501.9146933,248850.238,498.848913,2888,264,1813,1172.107897,134824.4412,1549,-950,331.4448248,71592.64429,1761,16122775,87925563,7030763
12560,2,-292,-30,153.60150349999998,3229.23999,56.82640223,262,676,1245,1020.561541,11606.30835,569,0,190.77219730000002,3030.725586,277,1509979,66658935,2329218
12561,2,-444,626,167.7561009,25773.15796,160.54020669999997,1070,833,1137,1023.2195820000001,1663.772461,304,29,165.7341621,2315.834961,327,1801095,67006612,1757940
12562,2,-2979,1707,539.556777,217197.0037,466.0439933,4686,313,2372,1072.50939,68188.83568999999,2059,-1435,278.2523023,54462.62402,2048,18631777,73617689,4955158
12563,2,-565,50,236.7267676,18766.43359,136.9906332,615,539,1588,1034.919841,35212.21069,1049,-118,149.5423748,5782.335693,464,3586532,68547781,1431227
12564,2,-555,636,217.0583519,46979.55054,216.7476656,1191,147,1931,1049.66194,118532.0225,1784,39,291.1882177,15498.24194,782,3015317,70514572,5426597
12565,2,-909,90,294.8324736,26271.7334,162.0855743,999,245,1549,998.4986777,51091.40015,1304,-39,147.8051927,4578.772461,296,5563276,63807975,1398168
12566,2,-919,1242,407.4184543,164754.9333,405.90015189999997,2161,686,1509,1027.734363,17080.67554,823,-29,271.8750287,19641.59277,821,10623347,67599227,4730626
12567,2,-252,-20,167.2489256,958.1989745999999,30.9547892,232,950,1343,1026.864782,3505.944336,393,158,219.7737117,510.42553710000004,109,1790221,67484882,3091231
12568,2,-5000,3878,839.1702002999999,678875.9131,823.9392654,8878,-1921,4686,1175.07545,435957.5615,6607,-495,305.94349460000007,59647.60132,1821,45069224,88371348,5990491
12569,2,-272,-90,187.2027644,1188.875,34.48006671,182,950,1049,1006.2172039999999,437.0625,99,158,198.4731169,342.11303710000004,89,2242872,64798276,2521061
12570,2,-2707,666,457.72972369999997,144076.4648,379.57405710000006,3373,176,2107,1037.0914109999999,93911.1084,1931,-910,300.041117,55817.01342999999,1870,13409056,68835750,5761579
12571,2,-454,-50,221.420591,9170.698975,95.7637665,404,607,1205,1022.6438009999999,18364.70313,598,0,182.41851780000002,2382.960693,247,3137733,66931222,2129697
12572,2,-1646,727,545.7554827,264935.1501,514.7185154,2373,-49,2284,1215.9981369999998,289529.374,2333,-1207,346.30809530000005,67122.69312000001,2078,19062339,94633694,7675475
12573,2,-1080,151,300.4133871,40163.161869999996,200.4074895,1231,235,1705,1001.703034,92040.41309,1470,59,208.0897493,5895.366211,376,5775885,64218174,2771286
12574,2,-414,-10,270.8501661,4305.827147999999,65.61880179,404,794,1274,991.6024594,6760.902344,480,-69,159.9347523,3182.131836,346,4695028,62929628,1637064
12575,2,-1919,666,436.8860692,122258.1836,349.6543773,2585,401,1519,1016.358958,47060.65234,1118,-366,181.777981,14982.39429,880,12215644,66111074,2114767
12576,2,-1232,1888,434.633646,187646.1563,433.1814357,3120,49,1774,1011.6875140000001,42978.45215,1725,-683,684.681849,411586.0486,5484,12090010,65504744,30002511
12577,2,-1676,1535,507.6363579,178478.8103,422.4675257,3211,352,3058,1018.938549,118584.7341,2706,-1465,275.87029900000005,57425.220460000004,2059,16492459,66447089,4870683
12578,2,-262,-60,171.00904580000002,1365.530273,36.95308206,202,960,1049,1011.661404,294.93725589999997,89,138,194.2495978,676.65625,119,1871622,65501363,2414906
12579,2,-1717,696,366.6969755,88342.39818999999,297.2244912,2413,274,2235,965.0312738,129393.0935,1961,-386,237.1568244,16224.60718,1059,8605867,59602263,3599575
12580,2,-2656,1030,566.16862,281860.9336,530.9057672,3686,107,2352,1113.182417,207427.0313,2245,-1623,376.9955238,104936.9131,2484,20515002,79307206,9096040
12581,2,-2505,2242,585.9805084,278268.4443,527.5115585,4747,264,3088,1049.038823,115829.365,2824,-1455,307.01592999999997,65475.538089999995,2177,21975882,70430877,6032562
12582,2,-414,40,212.18461890000003,5408.874022999999,73.54504758,454,617,1137,996.9233608999999,11217.6709,520,49,214.05347609999998,2470.349365,337,2881428,63606796,2932409
12583,2,-414,2343,488.37151270000004,211461.9041,459.84987120000005,2757,264,1401,1032.639027,52514.62866,1137,-316,498.1966385,149849.0505,1910,15264431,68245975,15884793
12584,2,-1393,838,399.0145478,156294.9216,395.3415253,2231,333,1990,1021.105941,51823.74121,1657,-633,357.14230360000005,56611.631839999995,1326,10189607,66730070,8163240
12585,2,-161,474,117.6122469,11312.28687,106.35923500000001,635,931,1098,1016.182193,814.7021484,167,-108,252.29766030000002,6121.5896,474,885289,66088080,4073863
12586,2,-232,616,179.8658354,31789.13965,178.2950915,848,862,1117,1017.991719,1859.2282710000002,255,-108,224.7666498,6452.853271,454,2070510,66323657,3233283
12587,2,161,212,192.132116,134.70214840000003,11.60612547,51,960,1019,990.2940377999998,149.10839840000003,59,217,254.60189509999998,210.8398438,80,2362544,62763666,4148616
12588,2,-191,434,163.58679840000002,25739.638430000003,160.4357766,625,686,1343,1016.3637769999999,10716.35327,657,-89,257.5160796,14529.83984,663,1712681,66111701,4244130
12589,2,-111,636,163.77700159999998,18098.17871,134.5294715,747,931,1039,1000.976031,421.17944339999997,108,118,270.5937915,2498.246094,258,1716666,64124993,4686144
12590,2,-898,313,169.92953500000002,28679.60913,169.350551,1211,882,1500,1018.313925,5405.631836,618,-227,277.22325730000006,7560.398193000001,722,1848067,66365648,4918575
12591,2,-888,2909,510.9874784,254453.2126,504.4335562,3797,382,2107,1043.244938,94164.05371000001,1725,-683,418.6527312,91667.80835,2148,16710925,69655040,11217287
12592,2,212,252,231.55641859999997,83.984375,9.164298937,40,941,990,971.6477788999999,104.99121090000001,49,277,301.66120789999997,106.65600590000001,49,3431576,60422362,5823967
12593,2,-212,1767,448.42397630000005,148499.8398,385.35676960000006,1979,588,1382,1014.9905789999999,26953.23438,794,-386,351.7363626,81962.10059,1356,12869380,65933176,7917982
12594,2,-1444,1505,402.0372923,145524.822,381.4771579,2949,245,2686,1069.84276,95219.39063,2441,-2732,617.9473456000001,358492.9333,3999,10344575,73252066,24438971
12595,2,-1212,3383,644.0270399,367008.0916,605.8119275,4595,480,1754,1064.663907,69420.27905,1274,-574,504.28073780000005,175390.7412,2514,26545333,72544591,16275140
12596,2,-494,2515,421.6474386,163914.1396,404.8631122,3009,578,1637,1031.094094,31533.933589999997,1059,-1049,399.20726129999997,137286.335,3256,11378340,68041922,10199452
12597,2,-151,171,83.52918652,5267.819336,72.57974467,322,990,1068,1032.44278,333.5146484,78,49,125.64023540000001,1219.9960939999999,149,446536,68220038,1010270
12598,2,-393,464,201.6705234,13404.73438,115.7788166,857,803,1196,1005.219915,4677.472412,393,-544,273.5731164,32676.19434,1227,2602944,64669893,4789904
12599,2,-535,535,162.9871544,20490.55859,143.145236,1070,647,1509,1038.0415449999998,15213.52734,862,-1247,261.808106,49469.28491,1821,1700148,68961936,4386783
12600,2,-606,505,192.531288,31107.97437,176.37452869999998,1111,784,1284,1028.8976810000001,5633.788086,500,-742,222.70818909999997,25438.12109,1246,2372371,67752348,3174332
12601,2,-434,1202,195.7114426,33589.288089999995,183.27380630000002,1636,794,1764,1042.7957310000002,13867.921880000002,970,-782,188.21256269999998,22155.80859,1207,2451390,69595068,2267134
12602,2,-2373,2454,672.1384367,442083.2126,664.8933844,4827,254,2901,1111.707049,145173.4219,2647,-1069,398.9282909,137221.2773,1861,28913285,79097124,10185202
12603,2,-595,666,223.4074193,44663.68359,211.3378423,1261,627,1558,1028.404514,11534.3584,931,-1801,390.7954028,112752.2908,2672,3194296,67687414,9774147
12604,2,-2030,1242,502.4161311000001,238238.6475,488.0969652,3272,186,3166,1076.561707,120719.6384,2980,-1237,343.3102642,89142.28027,2167,16155006,74175047,7543164
12605,2,-70,343,121.4035111,3621.7460939999996,60.18094461,413,862,1166,1027.908799,2188.413086,304,69,164.541788,1001.8427730000001,158,943284,67622176,1732736
12606,2,-1080,1171,329.1685311,102338.4041,319.9037419,2251,578,1617,1030.299835,23857.194340000002,1039,-821,234.744309,31738.9021,1484,6934523,67937136,3526713
12607,2,-858,888,276.6928577,67474.46484,259.7584741,1746,725,1627,1042.452772,17357.89746,902,-1148,280.9883783,67465.30859,1553,4899772,69549298,5053086
12608,2,-848,2848,567.7574856000001,293363.5,541.630409,3696,254,1480,1021.6058439999999,46426.60938,1226,-1267,417.02191939999994,151957.0068,3187,20630308,66795424,11130066
12609,2,-414,2818,487.9153199,209421.0857,457.6254863,3232,441,1980,1055.159444,58728.73217999999,1539,-564,169.07404069999998,16035.03027,880,15235927,71255133,1829506
12610,2,-424,373,126.7888254,15008.97559,122.5111243,797,774,1519,1048.49854,13324.67188,745,-1168,272.74166460000004,62537.6521,1831,1028826,70358348,4760833
12611,2,-222,2121,395.4113167,124101.8064,352.2808629,2343,715,1647,1068.79823,22833.40234,932,-702,260.03749730000004,39227.25,1385,10006407,73109098,4327648
12612,2,-595,474,175.08163269999997,28437.22827,168.6334139,1069,627,2009,1044.101932,28154.18652,1382,-2009,370.5457757,121901.0349,2504,1961829,69769526,8787467
12613,2,10,353,148.59955630000002,4924.921631,70.17778588,343,862,1176,1022.794961,2391.890625,314,-326,219.46002630000004,18487.257569999998,1078,1413237,66951010,3082413
12614,2,-4767,4646,906.8107059,814115.4063,902.2834401,9413,294,2382,1056.323185,125886.9509,2088,-1752,360.1358034,107900.0427,2821,52627562,71412395,8300659
12615,2,-656,1343,304.7200816,76950.75366,277.39998860000003,1999,607,2205,1071.767429,57215.50757,1598,-2504,650.1018188999999,412145.335,3385,5942677,73515867,27048472
12616,2,-131,343,128.6967123,4442.209961,66.64990593,474,862,1205,1029.0992039999999,1714.976318,343,-752,204.1687415,25220.77734,1118,1060022,67778891,2667832
12617,2,101,353,236.67253880000004,2818.792725,53.09230382,252,892,1088,972.3637999,1952.323975,196,247,324.7622207,1060.734375,129,3584889,60511447,6750112
12618,2,-313,2333,510.5680966,159297.2412,399.1205848,2646,215,1460,964.0864360999999,39742.09375,1245,59,362.4520011,12680.437259999999,742,16683506,59485610,8407773
12619,2,-222,1131,370.847151,43671.54272,208.9773737,1353,647,1166,968.8155139,10030.35938,519,69,310.44089110000004,7019.259520999999,495,8801767,60070624,6167907
12620,2,-10,373,224.422488,7600.505615000001,87.18087872,383,696,1509,991.0537242999999,21695.607180000003,813,158,311.5233488,4526.267334,287,3223389,62859999,6210995
12621,2,-373,777,250.58818309999998,24108.46484,155.269008,1150,647,1254,981.8921386,12969.13257,607,-603,355.0641227,27533.397460000004,1197,4018844,61703179,8068514
12622,2,101,262,202.4232879,975.1875,31.22799225,161,872,1068,982.1559751,1993.43335,196,237,298.2589584,526.515625,119,2622412,61736343,5693338
12623,2,10,272,141.047975,2478.780273,49.78735054,262,774,1166,997.3421788999999,3826.712646,392,138,287.7181238,1467.631836,287,1273250,63660251,5298030
12624,2,-545,1222,337.0444843,83143.28101,288.3457664,1767,588,1676,990.3214360999999,34159.57202,1088,0,319.82873839999996,13626.05444,722,7270335,62767139,6546587
12625,2,-373,2202,424.0293143,115973.57400000001,340.54893039999996,2575,294,1598,990.7728596000001,25849.667719999998,1304,19,332.07552789999994,11972.311520000001,812,11507255,62824375,7057546
12626,2,60,141,101.1709568,403.6005859,20.08981299,81,960,1049,998.7315705,400.0927734,89,247,296.4683794,277.5,79,655076,63837744,5625184
12627,2,151,282,227.4685074,785.9138184,28.0341545,131,911,1049,982.7961147,1042.445068,138,217,280.18333839999997,565.767334,119,3311483,61816845,5024173
12628,2,-474,1616,427.9959842,121800.5,348.9992837,2090,519,1490,987.2273912,32596.02515,971,79,348.671855,8802.027344,604,11723556,62375547,7780612
12629,2,20,1636,330.51621560000007,52313.99121,228.7225201,1616,549,1509,991.5359692,10855.138429999999,960,-188,332.8280571,7783.665770999999,702,6991422,62921189,7089569
12630,2,-616,2282,492.7264232,169820.2537,412.0925305,2898,568,1578,978.4592240000001,21719.208740000002,1010,-178,377.757921,18609.976319999998,989,15537877,61272477,9132867
12631,2,-919,4757,910.5517815,714680.9138,845.3880256000001,5676,-19,2823,1093.329298,209226.8572,2842,-742,297.5830766,78618.08984,1197,53062691,76503613,5667564
12632,2,-1232,3777,890.9192232999999,713417.96,844.6407283,5009,-176,2715,1136.416806,243571.0381,2891,-1742,512.3041393999999,250656.1406,2870,50799172,82652362,16797154
12633,2,-969,3727,632.6566259,358421.374,598.683033,4696,-735,2460,1153.5129630000001,285916.5225,3195,-485,266.7530752,47010.95679,1158,25616282,85157898,4554061
12634,2,-1898,5121,1247.8041460000002,1428940.6719999998,1195.383065,7019,-264,1941,1211.1674699999999,222133.1775,2205,-762,408.2708966,144891.9844,2148,99648972,93883305,10667848
12635,2,-1949,3474,704.3816437,434447.835,659.1265698,5423,558,2735,1115.986909,78756.76563,2177,-2693,605.8715056,350919.5156,3970,31753824,79707314,23493138
12636,2,-60,828,211.9683423,13739.70679,117.21649540000001,888,480,1460,1013.315914,18196.927490000002,980,-19,183.68532019999998,3903.132568,316,2875557,65715785,2159379
12637,2,-929,767,304.53558389999995,57673.50757,240.15309190000002,1696,490,1598,1014.254568,35606.65405,1108,-2148,474.9932893999999,192596.9209,3306,5935483,65837589,14439592
12638,2,131,585,281.603611,6383.717772999999,79.89817128,454,539,1215,1004.149819,18260.76538,676,-178,100.1978511,5464.355225,346,5075238,64532279,642535
12639,2,-1666,1484,539.1211454,270189.2009,519.7972691000001,3150,274,2813,1082.692268,156316.0408,2539,-2504,702.2055321,477836.4998,3860,18601703,75022243,31557927
12640,2,-1545,5131,1161.0130880000002,1277933.269,1130.457106,6676,-1215,2254,1145.309681,320869.5564,3469,-1148,542.7753621,248285.9834,4286,86268889,83950993,18854726
12641,2,-161,262,95.78834089,6415.874022999999,80.0991512,423,980,1098,1027.483812,384.11499019999997,118,79,174.9170786,1913.386475,257,587226,67566271,1958143
12642,2,-343,1353,419.0762535,77028.90625,277.5408191,1696,460,1450,1009.6586679999999,42957.850589999995,990,-801,213.0706309,38452.913089999995,1216,11239994,65242280,2905542
12643,2,-747,1535,330.94091710000004,72495.71265,269.2502788,2282,588,1960,1075.2926929999999,41250.37109,1372,-1425,434.2970614,175027.1211,2395,7009401,74000280,12071292
12644,2,-575,616,190.22240269999998,22706.80371,150.6877689,1191,735,1284,1025.726374,6544.436522999999,549,-782,238.62195519999997,35761.092769999996,1484,2315812,67335334,3644188
12645,2,141,313,235.25109590000002,1250.4938960000002,35.36232312,172,931,1137,1014.0944699999999,951.953125,206,29,92.96824054,772.0771484,129,3541957,65816806,553158
12646,2,-1020,2565,688.212642,390629.6287,625.0037029,3585,176,1607,1057.959859,87784.92188,1431,-603,242.34321609999998,54782.861079999995,1226,30312745,71633860,3758735
12647,2,151,252,199.3441199,515.5134277,22.70492078,101,980,1039,1008.652884,150.8063965,59,138,175.2821832,317.203125,89,2543237,65112361,1966326
12648,2,-393,696,282.2156478,33548.239989999995,183.1617864,1089,490,2617,1082.3690960000001,56419.85913,2127,-2524,423.235713,178287.4688,3276,5097323,74977463,11464222
12649,2,-535,1373,389.9836335,117729.1365,343.11679710000004,1908,607,1431,1024.234165,37208.24121,824,-1445,474.4533697,202662.2148,2345,9733583,67139560,14406784
12650,2,-747,4000,707.8503218,399161.4431,631.7922467999999,4747,215,1843,1061.1288140000001,112543.1775,1628,-534,183.77937690000002,31235.644289999997,1147,32067333,72063639,2161591
12651,2,-2525,4040,671.6633504,405589.4287,636.8590336,6565,-529,3588,1107.691984,169811.9961,4117,-4306,654.1944355,402455.2888,5771,28872426,78526818,27390103
12652,2,-1878,3525,709.1732422,380010.71,616.4500872000001,5403,-19,2254,1052.840852,106316.44699999999,2273,-356,250.3636418,54522.782960000004,1068,32187308,70942327,4011645
12653,2,-1696,4888,1060.428098,1033812.663,1016.7657859999999,6584,107,2784,1123.690057,266924.8281,2677,-2564,672.7726445000001,443012.9053,4009,71968496,80811478,28967874
12654,2,-454,1858,384.13756889999996,73857.90601,271.76811069999997,2312,274,1980,1023.1531150000001,54172.564210000004,1706,-366,178.2290047,30510.8689,1118,9443947,66997907,2032997
12655,2,-1262,3070,703.4406736000001,410583.7188,640.7680694000001,4332,-68,2852,1049.780089,178967.6482,2920,-1485,329.3917216,96624.71777,1980,31669042,70530447,6943930
12656,2,-727,1969,481.0064643999999,178711.3115,422.74260669999995,2696,254,1872,1033.950321,44308.302489999995,1618,-1366,393.4699202,135388.8318,2257,14807502,68419409,9908389
12657,2,-1151,2969,736.7068723,427911.3396,654.1493252,4120,29,1813,1084.1235800000002,115067.5898,1784,-475,261.8492827,60724.4978,1484,34735169,75220732,4388163
